ID;Nazwa;;Ilosc Real;Ilosc Fakt;Roznica Fakt Norm
1;SŁOŃ DO ROZKRĘCANIA W WORKU /870043/            700431;3;40;43;
2;Pierścionki135677;31;0;31;
3;Pierścionki 133758;6;72;78;
5;TARCZA Z RZUTKAMI /7839828/                     398286;14;21;35;
7;LADOWARKA 29CM /548784/                         487847;5;31;36;
9;PISTOLET METALOWY NA SPłONKę  /7888B            516093;12;0;12;
11;PISTOLET NA SPLONKĘ    /CHT2927804/              081027;-66;109;43;
12;PISTOLET NA SPłONKę /CHT40985/                  047337;13;45;58;
13;PISTOLET NA SPłONKę /CHT409A16                  047344;35;54;89;
14;PISTOLET NA SPłONKę /CHT409B29                  047351;14;39;53;
15;PISTOLET NA SPłONKE /CHT409C13                  002275;38;0;38;
16;PISTOLET NA SPłONKę /CHT409C25                  047375;-6;103;97;
17;PISTOLET METALOWY NA SPłONKę /S703B/            510657;20;12;32;
19;PISTOLET NA SPłONKę /CHT409A52                  047368;118;2;120;
23;PISTOLET NA SPłONKę /CHT2927805;69;33;102;
24;KLOCKI ŚREDNIE /K2S/                            000055;2;4;6;
25;PISTOLET NA SPłONKę /CHT409C26                  047313;820;897;1717;
26;PISTOLET METALOWY NA SPłONKę /S902BN            514174;8;29;37;
27;PISTOLET NA SPłONKę /8247SP/                    516222;20;254;274;
28;KLOCKI 3 MAŁE /K3M/                             000161;6;1;7;
37;KLOCKI BOBO -  50                               306725;4;9;13;
38;DZWONKI CHROM.27 TON                            000049;1;5;6;
39;KRĘGLE MAŁE /TOYS/                              306084;1;0;1;
48;AUTKO 12CM. W WORKU /8680833/                   808333;0;6;6;
49;Cymbałki /TA9901-2/003165/;7;0;7;
50;Komplet do prasowania /000155/;3;0;3;
52;Miękka piłka i kostka /004636/;1;0;1;
53;Zwierzęta domowe 8szt w worku /397041/;4;0;4;
59;ŻELAZKO B.O. Pryska wodą/960308/;6;3;9;
62;KLOCKI sluban wojsko (121 el.) /G045278/;1;5;6;
63;KULKI WODNE  X20;155;1091;1246;
69;MASZYNA ROLNICZA  /157257/   MANITU M           572570;0;0;0;
87;ZESTAW NOŻYCZKI+CĄŻKI  /PB1506/                 085063;0;31;31;
89;BEZPIECZNE CĄŻKI  /PB1718/                      085022;0;33;33;
90;ŁYŻECZKI SYLIKONOWA KOŃCÓWKA 2SZT./PB3207/      085121;0;25;25;
93;ROBOT 29CM.CHODZI,OBRÓT /ZR28112A/              075108;0;0;0;
96;ZESTAW SZCZOTECZEK DO ZĘBÓW /PB40307/           085091;0;29;29;
99;KUBEK ZE SŁOMKĄ 180ML. /PB8203/                 085107;2;2;4;
100;WAGA SZALKOWA /CZ/                              000056;0;6;6;
103;WACHLARZYK 21CM.  X12  304251;-45;79;34;
105;AUTKA METAL OTW.DRZWI  X24 BOX /294/            054145;0;0;0;
106;Świecące naszyjniki, w.box 12szt z bateriami /397386/;0;12;12;
107;Lusterko św, dźw, display 12szt /397478/;0;10;10;
108;Samochiki metalowe displ. 36 szt /396365/;41;0;41;
112;Auto czerwone-metal 12cm, Światło, Dźwięk 300209;1;21;22;
115;"KASA B/O.""C.REGISTER"" NO.66030  /G57114/        958536";0;4;4;
117;BEZPIECZNE NOŻYCZKI  /PB1703/                    08501;-5;9;4;
118;TERMOMETR DO KĄPIELI RYBKA /PB1716/              08500;0;24;24;
120;TRAKTOR Z PŁUGIEM 104973;14;19;33;
121;SKRZYDŁA ANIOŁA+RÓŻDŻKA,KORONA /ZR3374/         074738;-15;26;11;
122;Lalka Syrenka 29cm Display 12/48 300710;2;46;48;
126;TRAKTOR MNJ.Z OPRYSKIWACZEM  2055 /66406/966405;19;0;19;
130;JEEP CZARNY S.W.A.T. /111-1/    KLOSZ           004586;0;0;0;
142;Harmonijka 16 tonów 817599, 807509;0;19;19;
147;KOŃ W WORKU 005930;0;0;0;
154;PIŁKA NOŻNA   302028;3;13;16;
169;BALON DEKORACYJNY 10 (MIX KOLOR.)  /830105/;0;0;0;
171;ŚMIGUSOWKA SŁONIK  /OPK.25SZT/;25;0;25;
174;AMBULANS 27 cm, otw drzwi /SA3766A/;0;0;0;
180;Miękka ślizgo-piłka 392749;0;0;0;
184;LATAJĄCY SOLARNY MOTYLEK  /BJ/2015              615653;17;0;17;
186;Lalka w sukni balowej /TAT2068-19/393500/;5;0;5;
196;ORGANY NA PRĄD Z MIKROFONEM 80CM /-3738/        960034;1;0;1;
197;ORGANY NA PRĄD + MIKROFON 60CM./SD3007/         002834;1;0;1;
198;"RESORAKI METAL ""10""  /FW-9910/                  004272";0;0;0;
204;Klocki Sluban Policja (126 el.) 957423;1;69;70;
208;Klocki policja commando 391902;4;153;157;
220;ZESTAW KOWBOJA NA KARCIE /G045030/              949251;2;28;30;
221;Szybkie Auta Metal RC /display 4szt/300650;16;23;39;
227;KARABIN B/O. Z PASKIEM 09952,992755;15;93;108;
234;Auto speed car RC 300728;2;21;23;
252;ZESTAW KORALIKÓW PUD./022732/REG                613628;0;0;0;
257;6 Autek 7cm wys. Koła 300032;27;0;27;
259;KLOCKI SLUB. BUS POLICJA 127EL. /G032479/       954880;0;0;0;
260;Piłka 20 cm włochata 135257;2;24;26;
269;PIŁKA DMUCHANA 27CM.Z DZWONKIEM /F2659/         072422;0;0;0;
270;PIŁKA DO KOSZA 302004;7;8;15;
281;KOLEJKA B/O. Z TOREM  /013021/                  616087;0;0;0;
283;CIĘŻARÓWKA METAL 4WZ. /2211-4/  PUD.            066146;2;0;2;
303;Auto śmieciarka display 12 szt. 995616;2;45;47;
313;DINOZAUR/                                       142818;2;7;9;
330;TRAKTOR Z BETONIARKĄ /90096/NC                  990096;0;0;0;
334;STRÓJ POLICJANTA  /004025/                      615042;1;1;2;
337;AUTO B/O. STAWIAJĄCE KLOCKI /010488A/           817534;0;7;7;
338;MUCHA ZE ŚWIATŁEM NACIĄG SZNUREK /14364/BC      617954;6;6;12;
347;AUTO SPORT 22CM. W WORKU /016380/               620756;1;0;1;
355;KAPELUSZ DZIEWCZYNKI 4KOL. /ZRPIE928/           055179;2;235;237;
359;"ZESTAW LALEK 7"" W PUDEŁKU /MPA12116/            121162";2;1;3;
363;NAKLEJKI WYPUKŁE /ZRYL0004-003/                 054929;0;0;0;
366;PIŁKA MAGICZNA  /MPG26730/ 267303;8;0;8;
382;LALKA LODOWA 2SZT.W PUDEŁKU                     293726;0;0;0;
384;GRA CHIŃCZYK+WARCABY  /NAKŁON/                  800181;2;5;7;
408;"LALKA 12 DZW. 16"" PIJE/SIUSIA /MPH08436/        084368";4;9;13;
412;Zestaw do badmintona 994480;3;42;45;
420;Lalka /994100/;-1;3;2;
424;MATERAC PLAŻOWY 208X116CM. /469079/             469079;2;1;3;
429;Piłka do ściskania (światło) 12 szt. disp. 84115;27;112;139;
431;Piłka pluszowa pompowana 20 cm /TG403626/141149/;4;0;4;
443;ZEGAREK DZIECIĘCY PLAST.DUŻY X10                009807;126;250;376;
448;Lizak policyjny 131808;5;48;53;
449;Piłka nożna premium TPU /50  302035;3;23;26;
450;TRAKTOR Z PŁUGIEM MNJ./5560317/  NEW.           603174;0;10;10;
453;Gumowe kaczuszki do kąpieli 4szt 303827;3;16;19;
459;AUTO KONTENER 27CM. 2KOL.  O/D                  336339;0;0;0;
465;Śmieciarka, światło, dźwięk /394521/;0;0;0;
471;KARABIN PUKAWKA Z LUNETĄ /266198/               661981;41;0;41;
472;KIBELEK-PIERDZĄCA MASA WKSZ. X24 /TG018493      670999;0;0;0;
473;Brelok Emotik x12;60;119;179;
477;PŁYWACZEK RYBKA /TG190751/   BC                 872818;-1;1;0;
482;WOJSKO Z PLANSZĄ ŚREDNIE /WOC10-8/  3WZ.  28485,407471;22;1;23;
486;ZWIERZĘTA DZIKIE 4SZT. /ZR666C-24/  WOREK /214125/305166/;-2;13;11;
489;KLOCKI SLUBAN 111EL. WYWROTKA /G032473/         955207;1;3;4;
500;Puzzle Drewnanie /Q3033/132676/;1;4;5;
501;Puzzle drewniane zegar /Q3032/132638/;3;1;4;
502;Piłka do ćwiczeń 24 szt.;116;12;128;
503;"Auto Metal 3"" /O382/115242/";11;0;11;
506;PIASEK KINETYCZNY 1KG. /TG365120/               800463;0;0;0;
510;Zwierzątko na baterie /Q2816/129522/;0;9;9;
512;PAMIĘTNIK NA SZYFR  /TG365131/                  878667;8;0;8;
514;Piłka Nożna /50 302042;6;14;20;
515;Auto tir policyjny 992786;12;23;35;
516;PRALKA B/O. ŚW/DZW. WODA /G014206/              908586;0;0;0;
522;WACHLARZ  X12;851;927;1778;
524;KULKI W GRANACIE  X24 ;140;34;174;
525;KULA MAGICZNA  X 12SZT /G076031/                970330;23;12;35;
529;"AUTO ""SONIC 2""  23CM. /Q2371/ 3KOL.WOREK        116225";11;8;19;
531;KARTY DO GRY   / 975649 / ;0;0;0;
540;Edu Alfabet (Fan) /804006/;0;0;0;
542;Kucyk w jajku 12.5cm 300544;15;0;15;
545;GNIOTEK szt. / x5  paczka/  850028;236;25;261;
546;Piłka miękka x12 szt. 983422;24;50;74;
547;PIŁKA POMPOWANA ;5;9;14;
548;PIŁKA 24  POMPOWANA  X10;8;0;8;
549;GRA ZNAKI DROGOWE/LEŚNY TELEFON   (FAN)         802637;2;0;2;
551;PROFESOREK Wyrazek - składa wyrazy;3;0;3;
552;Pamiętnik otwierany różdżką 136797;2;0;2;
553;AUTO METAL OTW.DRZWI  /0304/BLISTER             081660;9;0;9;
560;GRA ZOSTAŃ GWIAZDA  3GRY      (FAN)             803016;2;3;5;
563;GRA ZOSTAŃ LEKARZEM     (FAN)                   802903;5;4;9;
564;GRA ZOSTAŃ POLICJANTEM     (FAN)                802897;2;2;4;
565;Piłka gumowa z rączką 994527;20;49;69;
566;GRA ZOSTAŃ STRAŻAKIEM     (FAN)                 802880;1;2;3;
567;PROFESOREK Cyferek - liczenie;4;5;9;
568;GRA EDUK.WESOŁE ZAGADKI  2GRY    (FAN)          804020;0;0;0;
569;Ułóż Wyrazy Ekologia   804082;1;5;6;
571;GRA PAN DOKTOR  3GRY   /(FAN)                   802576;0;0;0;
573;UKŁADANKA-KOLOROWY SAD  (FAN)                   803108;1;2;3;
574;Deluxe szachy (Fan)/804099/;0;4;4;
582;GRA EDUK.BEZPIECZNA DROGA  2GRY   (FAN)         804037;0;0;0;
585;GRA EDUK.MALI EKOLODZY  2GRY   (FAN)            804044;0;2;2;
586;GRA UŁÓŻ WYRAZY JUNIOR   (FAN)                  804075;5;0;5;
589;GRA UŁÓŻ SZYFR KOLORY I FIGURY   (FAN)          804402;1;4;5;
590;GRA GWIAZDY NA ZAKUPACH  2GRY    (FAN)          804365;0;1;1;
597;"BALON METALIZOWANY 10"" MIX KOLOR                831584";0;0;0;
598;GRA WARCABY & CHIŃCZYK       (FAN)              802194;2;0;2;
605;KLOCKI FURGON POLIC. 206EL.(B1900)/G32482/      957348;1;7;8;
608;OKULARY - KARTA X 1 OP. /MPA80265/              802658;0;0;0;
611;LALKA + 4 SUKIENKI /961849/                     618490;0;0;0;
613;"JEEP ""POLICE CAR"" F/F.RADIO+ŁADOW. /Q1145/      098491";0;0;0;
614;KLOCKI DOMEK 149EL.(B0570) /G078215/            969914;0;0;0;
616;MERC. 1:24 F/F.RADIO+ŁADOW.  /Q2192/            120550;0;4;4;
621;KLOCKI AUTO KAMPER 324EL.(B0566) /G078219/      969952;0;0;0;
622;PERUKA IROKEZ  /ZRPIE905/   W0127         58880,901457;1;18;19;
626;BMW 1:24 RADIO F/F.+ŁADOW. /Q2193/              120543;2;1;3;
632;KOŃ NA BIEGUNACH-DZWIĘK /Z4237/    ŁATY         973577;0;0;0;
634;KOŃ NA BIEGUNACH-DZWIĘK /Z4238/                 973584;0;0;0;
640;AUTKO Z MUZYKĄ I ŚWIATŁEM /MPE54835/  PUD.      548358;0;0;0;
642;BADMINGTON 2RAKIETKI-POKROWIEC /64104/          964104;0;0;0;
648;ZEGAREK BRANSOLETKA  X10   MAŁY;146;910;1056;
649;Dentysta 136308;0;0;0;
652;Art. rozrywkowy gluty z insektami /48szt displ/807769;79;2;81;
655;WÓZEK WIDŁOWY 18CM. /746266/  KLOSZ       15496,462668;35;0;35;
661;"TELEFON KOMÓRKOWY ""PRINCESS""  /D666905/         291481";0;0;0;
666;"PISTOLETY ""WESTERN COWBOY"" /MPB68648/ BLIS      686487";9;15;24;
679;Pieluchy dla lalek 5 sztuk/302967/;1;15;16;
684;LATAJĄCA BILA MNJ.W SIATCE 303223;3;22;25;
685;Miecz na bańki 24 szt. display 479829;0;55;55;
693;SAMOLOT STYROPIANOWY W FOLII  09553335 szt. w pudełku;-25;25;0;
696;PING PONG 2RAKIETKI+3PIŁKI 302530;15;15;30;
709;NACZYNIA Z KUCHENKĄ W WORKU /ZRH1229/           113152;0;0;0;
714;ZESTAW DO TENISA-2RAKIETY 53CM. /SPY112810      098053;2;5;7;
718;PAJĄK NA KABEL B/O /G069889/ BLISTER            969624;4;0;4;
720;TRAKTOR Z WIDLAKIEM NA LAWECIE /433285/         332858;0;0;0;
721;Wiatraczek podwójny (8 szt.)136957;1.125;4.875;6;
724;WAŃKA WSTAŃKA MIŚ ŚW/DZW      961585;34;0;34;
741;ŚMIGUSÓWKA JAJKO MAŁE  /OP.25SZT./;0;0;0;
742;ŚMIGUSÓWKA JAJKO DUŻE  /OP.25SZT/;200;0;200;
743;ŚMIGUSÓWKA JAJKO MAXI /OP.25SZT/;390;0;390;
744;ŚMIGUSÓWKA ŻABKA  /OP.25SZT./;0;0;0;
746;ŚMIGUSÓWKA RYBKA /OP.25SZT./;200;0;200;
752;Gierka do Grania 300681;31;14;45;
753;Jeep z naczepą + auto048123;0;5;5;
756;KLOCKI MAŁE /K1BD/ WOREK DUŻY                   000031;0;9;9;
763;PISTOLET KOSM. ŚW/DZW. /MPG45891/  WOR.         458916;0;0;0;
768;ŁOPATKA,GRABKI /HEM/                            002462;10;0;10;
771;Auto 02963;0;5;5;
775;GITARA-DREWNO  /001310/                         607757;0;0;0;
783;KÓŁKO NADM.51CM.-HELLO KITTY /SP56200/          562008;3;1;4;
797;NOCNIK-FOTELIK  /5056/                          502658;0;0;0;
800;Zestaw policyjny 963138;25;25;50;
807;Auto 727212;1;5;6;
811;SPRĘŻYNA Z GWIAZDKAMI 6,5CM /G031170/     56784,926658;88;259;347;
812;SPRĘŻYNA TĘCZOWA 8CM 42026,447514, 398772;117;296;413;
814;Latający dysk ze światłem 399052;0;0;0;
816;KOMBAJN DO KUKURYDZY 34CM. /6275457/      00238,751570,754661;4;9;13;
819;ZESTAW LEKARSKI /Q2719/129171/;2;7;9;
825;Spiner /969567/968744/;13;62;75;
832;Auto laweta + 3 quady807065;2;3;5;
840;Zestaw lekarza /005169/;2;0;2;
845;PRZEWROTKA  POLICJA NA BATERIE  /62797/         962797;14;37;51;
849;Yoyo z buźką duże 301366;5;50;55;
855;Wędka + 6 Rybek 3000766;8;23;31;
860;Auto 367937;2;1;3;
870;KOSIARKA DO TRAWY  /SYP/                        300095;6;0;6;
875;BATERIE AG-13  1OP.=10SZT.;0;7;7;
899;AUTKO BUDOWL.4WZ. W WORKU /556877/              568775;1;0;1;
910;TIR z lawetą + 4 autka233575;5;36;41;
911;LALKA 8SUKIENEK + AKC. 256405,564053,289778;24;37;61;
913;PIŁA MOTOROWA 33CM. B/O. 2357199, 61417,571993;78;63;141;
920;Auto jeep laweta + helikopter283586;0;5;5;
921;KOPARKA NO.312  40CM./60328/  KLOSZ             960328;8;0;8;
927;Gra statki /TAJT881/392299/;1;0;1;
938;Kucyk 7cm w jajku 300537;29;75;104;
944;Auto tir laweta 2 poziomy + 8 autek budowlanych249185;0;7;7;
954;UKŁADANKA MOZAIKA W PUDEŁKU /MPA33275/          332759;0;0;0;
960;Robot Kuchenny A /960339/;0;3;3;
968;Art. rozrywkowy glut świnka 12 szt. disp. 983903;-12;96;84;
969;WACHLARZ - KWIATY C. X12  /TG365102/            878612;73;0;73;
972;Elektroniczne zwierzątko 966306;28;117;145;
974;Zestaw policjant 967815;48;60;108;
978;TELEFON KOM.T618 W PUD. /MPH35704/ 357042;37;0;37;
979;TIR z lawetą dwupoziomowa + 4 autka103321;5;50;55;
981;Ułóż wyrazy Girls (Fan) /9804051/;0;4;4;
987;LALKA WRÓŻKA LATAJĄCA MNJ. /MPE97965/           979657;0;0;0;
990;Piłka do skakania z kolcami uchwyt 967477;19;25;44;
1000;Puzzle 30el. Uwolnij Magię  /182255/;0;5;5;
1001;Puzzle 30el Cars 3  /122156/;0;0;0;
1002;Puzzle 30el Strażak Sam /182132/;3;6;9;
1003;Puzzle 30el Wesoło Naprzód   /182132/;0;0;0;
1004;Puzzle 30el Tort urodzinowy  /182118/;0;0;0;
1005;Gra Alfabet  /003013/;0;0;0;
1006;Puzzle 100el Magia Avaloru  /163216/;0;0;0;
1007;Puzzle 3w1 Cars 3   /348200/;0;0;0;
1008;Puzzle 3w1 Tomek rusza do akcji  /348217/;0;0;0;
1009;Puzzle 3w1 Zabawy w szkole  /348132/;0;0;0;
1010;Puzzle 3w1 Zosia i jej przyjaciele   /348149/;0;0;0;
1011;Puzzle 3w1 Słodkie kotki   /348095 /;0;0;0;
1012;Puzzle 3w1 Uwaga Duchy   /341454/;0;0;0;
1013;Puzzle 3w1 Po wyścigu   /348194/;0;0;0;
1014;Gra Bajkowi Ulubieńcy  /005758/;0;0;0;
1015;Gra Sylaby  /005888/;2;1;3;
1016;Gra przeciwieństwa - gra /004652/;0;5;5;
1017;Gra kto silniejszy  /005796/;0;3;3;
1018;Puzzle Dino 24 maxi Jungle Book  /350069/;0;0;0;
1019;Puzzle Dino 100 xl Planes  /771079/;0;0;0;
1020;Puzzle Dino ramkowe 25 el śnieżka  /311237/;0;0;0;
1021;Puzzle Dino 24el Cars 2  /351332/;0;0;0;
1022;Karty Piotrusie Memo Cars 3  /100351/;3;10;13;
1023;Karty Piotruś Memo Despicable  /100368/;1;13;14;
1024;Samolot 43cm .św/dźw. w worku  /248171/          481718;-10;48;38;
1025;DINOZAUR NA BIEGUNACH (DZWIĘK) /Z0733/          929895;-1;1;0;
1027;Puzzle 60 el. Przyjaciele z Krainy Lodu /172751/;0;0;0;
1028;Puzzle 160el. Zimowe przygody   /153446/;0;0;0;
1029;Puzzle 30el. Przyjaciele przed hangarem  /182262/;0;1;1;
1030;WYRZUTNIA DYSK  /B6684/                         241264;-19;28;9;
1031;UKŁADANKA EDUKAC.WĄŻ W FOLII /DAJ/              293661;19;0;19;
1032;Puzzle 60el. Lot dookoła świata  /173079/;2;6;8;
1033;Puzzle 100el. Przygoda czeka /163117/;0;0;0;
1034;Puzzle 100el. Świat Barbie   /163148/;0;0;0;
1035;Farba do malowania 6 kol. /TABV002/392862/;1;13;14;
1036;Puzzle 60el. Blaze  /173055/;0;0;0;
1037;Puzzle 2w1+memos Podniebni bohaterowie /906356/;1;1;2;
1038;Puzzle 60el. Cars 3 /172973/;2;1;3;
1039;Puzzle 200el. Marinnette i Adrien /132267/;0;0;0;
1040;Puzzle 160el. Cars 3  /153392/;0;0;0;
1041;Puzzle 2w1+memos Przyjaźń to magia /906011/;0;1;1;
1042;Puzzle 1500el. Portret Lwa  /261394/;0;0;0;
1043;Puzzle 1500el. Tower Bridge nad Tamizą  /261400/;1;0;1;
1044;Puzzle 300el. Tęten kopyt;0;0;0;
1045;Puzzle 500el. Misie polarne  /372700/;0;0;0;
1046;Puzzle 500el. Śpiące kotki /372717/;0;0;0;
1047;Puzzle 1000el. Galopujące konie  /104462/;0;0;0;
1048;Puzzle 1000el. Śpiący lew  /104479/;0;0;0;
1049;Puzzle 1000el. Wesoły kotek  /104486/;0;0;0;
1050;STATEK PIRATÓW NO.12602 /G057134/               960089;2;4;6;
1051;Puzzle 500el. Machu Picchu  /372601/;0;0;0;
1052;Puzzle 160el. Farmer Miki /153378/;0;0;0;
1053;Puzzle 2000el. Doha Katar  /270846/;0;0;0;
1054;PIŁKA MIĘKKA 7,6CM. BAJKOWA  X12 /TG365516      878780;0;0;0;
1055;Puzzle 200el. Wenecja Włochy;0;1;1;
1056;MIECZ ŚWIECĄCY  /HL319111/  WOREK               271120;2;24;26;
1057;Puzzle 260el. Sweet  /132151/;0;0;0;
1058;Baby Classic Tomek i przyjaciele /360660/;0;0;0;
1059;Puzzle 1000 Nowy Jork /102222/;0;0;0;
1060;Quizy Trolls    /609659/;0;0;0;
1061;Puzzle 1000el. Paryż  /394029/;0;0;0;
1062;Puzzle 1000el. Hoc Waterfall  /393855/;0;0;0;
1063;Pas z kaskiem i narzędziami 8201415;7;32;39;
1064;CATCH BALL 18.5CM. - ŁAPACZ  831878,963596;14;18;32;
1065;Puzzle 1000el New York  /393664/;0;0;0;
1066;Puzzle 1000el. National Geographic /393107/;0;0;0;
1067;Gra w kamienie /272755/;0;0;0;
1068;Pinokio-Trzy świnki /324269/;0;1;1;
1069;WACHLARZ 21 cm x 10  304237;17;51;68;
1070;Leśne przygody Pszczółki /324283/;0;1;1;
1071;Zamczyszko Wyspa piratów /324047/;0;0;0;
1072;Czerwony Kapturek Kot w butach  /324382/;0;0;0;
1073;Jaś i Małgosia Piotruś Pan  /324078/;1;0;1;
1074;Wilk i Zając-Pogoń /324108/;0;0;0;
1075;Królewna Śnieżka - Legenda o Smok Wawelski  /324146/;1;1;2;
1076;Podróże Guliwera-Księga Dżungli /324221/;0;0;0;
1077;Mała Syrenka-Calineczka /324238/;0;0;0;
1078;Mata do kolorowania /129980/;1;2;3;
1079;Mata do kolorowania /129997/;0;0;0;
1080;Gra Planszowa Bartek;14;0;14;
1081;Puzzle 60 el. Cars 3/172973/;0;0;0;
1082;Puzzle 60 przed pałacem /172393/;0;0;0;
1083;Puzzle 30 el. pachnące róże 18196;0;5;5;
1084;KONIK + akc. do czesania/395726/;13;22;35;
1085;Puzzle 30 el. nowe wezwanie /182149/;0;5;5;
1086;Puzzle 60 el. Wspólne wygłupy /172928/;1;0;1;
1087;Puzzle 60 el. Najlepsi przyjaciele /173093/;0;5;5;
1088;Zabawka do kąpieli /Q1971/119455/;2;0;2;
1089;Puzzle drewno /Q3035/132652/;0;5;5;
1090;Puzzle 100el. Shimmer and Shine /072569/;1;1;2;
1091;TRUCK Z PRZYCZEPĄ I ZWIERZĘTAMI /93127/NC       993127;0;0;0;
1092;Puzzle 2 w 1 + memos Disney Cars 3 /90706/;0;2;2;
1093;Puzzle 60el. Bob i Wendy 173000;0;5;5;
1094;Zwierzęta świąteczne /147790/;0;2;2;
1095;Bałwan grzechotka /135971/;0;1;1;
1096;PISTOLET NA MIĘKKIE STRZAŁKI /087013/ BC        870133;0;0;0;
1097;Puzzle 30 el. Zabawa i przygoda /182279/;3;1;4;
1098;Puzzle 100 el. Jedna drużyna /163322/;4;0;4;
1099;Puzzle 30 el. maxi Princesw 2 /074372/;0;2;2;
1101;LALKA BALOWA  /G075791/;3;8;11;
1102;Puzzle 40 Floor shimmer and shine /254514/;0;1;1;
1103;Puzzle 60 el. Taniec i muzyka /172966/;0;0;0;
1104;Puzzle 30 el. Dołącz do zabawy /182163/;0;1;1;
1105;BUTELKA Z MLEKIEM /Q285/  BLISTER               081707;0;0;0;
1106;Zestaw kreatywny /128624/;0;0;0;
1107;Zestaw kreatywny /128617/;1;6;7;
1109;Puzzle 3w1 Magia przyjaźni /348231/;0;0;0;
1110;Puzzle 30 na stacji benzynowej /181371/;0;0;0;
1111;Puzzle 30 el. Wizyta w kurniku /181951/;0;2;2;
1112;Puzzle 60 el. Wyścig do mety /172843/;1;3;4;
1113;Puzzle 60 el. Podróż na Księżyc /172621/;1;0;1;
1114;Strażak sam;0;0;0;
1115;ZESTAW LEKARSKI /132799/;0;3;3;
1119;Metalowe autka sportowe, frict., disp. 12 szt. /397157/;14;3;17;
1120;ZESTAW POLICJA 003984;0;8;8;
1121;Puzzle 100 Pidżamersi w akcji /163346/;0;6;6;
1122;CZOŁG Z DZWIEKIEM  /KLX700-3A/   PUD.           004449;0;0;0;
1123;Puzzle 60 Jak dobrze mieć przyjaciela  /172782/;0;2;2;
1124;Puzzle 60 Finding Dory /084210/;0;0;0;
1125;Puzzle 500 POSITANO WŁOCHY    /371451/;0;0;0;
1126;Puzzle 100 el  Przygody Ladybug  /163230/;0;1;1;
1127;Puzzle 100 el.Vaiana i przyjaciele  /162981/;1;0;1;
1128;Puzzle 100 el. Frozen /162554/;0;3;3;
1129;Puzzle 100 el. Wesołe Wróżki /161595/;0;0;0;
1130;Pamięć /000627/;0;4;4;
1131;Gra pamięć sówka mondra główka /018226/;0;0;0;
1132;Kalambury obrazkowe mini /017861/;0;0;0;
1133;Piszę i Zmazuję Litery /006564/;1;0;1;
1134;Gra Memory /251393/;2;3;5;
1135;Zgaduj zgadula /002553/;0;0;0;
1136;Skojarzenia Pamięć /003284/;0;0;0;
1137;Remiza strażacka /133109/;1;3;4;
1138;Posterunek policji /B746/33086/;0;3;3;
1142;AUTO RADIO F/F.ŚW.,ŁADOWARKA  /ZMZR2016A        208735;0;0;0;
1148;SZACHY DREWNO  /Q1550/                          108169;0;0;0;
1163;LALKA PRZYTULANKA J.POLSKI /G076179/972020/TG364841/877356/;4;40;44;
1165;Helikopter  św,dźw /997832/;1;20;21;
1167;ZESTAW LEKARZA W PUDEŁKU 304534;0;0;0;
1170;LALKA + 11 SUKIENEK,AKC. /TG219703/             803594;0;0;0;
1171;Puzzle Magnetyczne Cyferki  017380;1;0;1;
1172;Poczta mini  003932;0;0;0;
1173;Mistrz Słowa-Mini  003475;1;1;2;
1174;Strażak Sam Skuter  007029;1;0;1;
1178;PAS Z NARZĘDZIAMI+KASK Z LATARKĄ /G032403 49123,921103;0;12;12;
1180;Puzzle 100 Walka dobra ze złem163360;0;3;3;
1181;Puzzle 200 el. Urodzony Bohater132359;0;3;3;
1182;Puzzle 100 el. Po lekcjach162530;0;2;2;
1183;Puzzle 100 el. Ucieczka162592;0;3;3;
1184;Puzzle 100 el. Jej Wysokość Zosia162264;0;1;1;
1185;Puzzle 100el. Przyjaciółki162288;0;5;5;
1186;Puzzle 30 el. List do Księcia  181166;0;3;3;
1187;Puzzle 30 el. Balia  181258;0;0;0;
1188;Puzzle 60 el. Rodzina Treflików  173086;0;2;2;
1189;Liczmany  013481;0;3;3;
1190;Puzzle 30 el. Przyjaciele na zawsze  182248;1;5;6;
1200;Miś Gift 20cm (siedzący 2 kolory /036599/;3;0;3;
1201;MOTOCYKLISTA 20CM. W WORKU /G075650/            966579;9;0;9;
1202;Miś Lilian 2 Kolory 31 cm /046024/;3;2;5;
1203;Miś Superbohater w bluzeczce 4 kolory 20cm /046239/;0;7;7;
1204;AUTO PRZWROTKA WKSZ. B/O. 0971154;26;73;99;
1205;Osiołek Donki Leżący 20cm /044068/;1;6;7;
1206;Osiołek Uszek - 25cm 2 kolory /047441/;-1;7;6;
1207;Pies Marceli w czapce 3 kolory 25cm /045034/;0;3;3;
1214;ZEST.DO ROBIENIA BANIEK Z RĘKAWICĄ/G063098      956785;7;8;15;
1227;BALONY DO MODELOWANIA /100/ RURKI /558012/;0;0;0;
1229;Głowa do stylizacji /G1779/130818/;0;0;0;
1236;PISTOLET NA SPŁONKĘ DŁ.LUFA 2541069/           410696;108;21;129;
1237;TRAKTOR610926;9;0;9;
1252;Konik z maleństwem i akcesoriami 399113;0;20;20;
1254;Puzzle 30el. Roszpunka Merida Arielka Śnieżka 181722;0;5;5;
1262;Zestaw fryzjerski 137138;0;20;20;
1264;Zestaw rycerza;10;11;21;
1273;JOJO ZE ŚWIATŁEM /778847/;18;1;19;
1276;Stemple roller /127641/;0;1;1;
1290;Bateria /10szt / AG13 /1154;31;29;60;
1292;BATERIA R6 PANASONIC  X 4SZT.;41;432;473;
1296;Pojazdy friction, św, dźw, 396280;24;0;24;
1299;ZEST.STRAŻAKA 923616;9;25;34;
1302;TRĄBKA ROWER.(PRZEZROCZ)962803;36;105;141;
1305;Zestaw grzechotek 392039;18;2;20;
1308;SZALONA KULA B/O.W FOLII  /L318/          40357,096394;0;0;0;
1309;LALKA SYRENKA 35CM.+AKC. /TA532-4/  BLIST       004902;0;0;0;
1310;SZALONA KULA B/O.W PUDEŁKU /MPI18470/184709;54;31;85;
1322;Młotek na baterie /G1516/123896/;7;2;9;
1324;JEEP 28CM. 689-166  /60038/P   KLOSZ            960038;0;0;0;
1331;Gra świat biznesu /800198/;2;8;10;
1334;PIŁKA NOŻNA 301533;13;0;13;
1351;LALKA Z AKCESORIAMI  /G089752/986126/;11;0;11;
1356;WAŃKA WSTAŃKA 4WZ./ZR981-991/                   215832;0;0;0;
1357;Deskorolka plastik 807875;0;12;12;
1365;WALKIE TALKIE ze światłem 003806;7;26;33;
1382;LOKOMOTYWKA - TELEFON DZW/ŚW. /ZM003/           106888;0;0;0;
1406;Piesek na smyczy /G016273/ 940760;10;8;18;
1434;"BALON DEKORACYJNY 10"" JEDNOKOL. /100/";0;0;0;
1459;Pojazd friction, św., dźw., bat zał. disp. 8 szt. 200456;12;32;44;
1464;Traktor   /573510 /;5;0;5;
1467;Płyn do baniek 0.5l 302363;59;61;120;
1475;Kalejdoskop   /124145/;14;1;15;
1476;ZESTAW POLICYJNY /66592X/;11;0;11;
1504;Pieniążki edukacyjne /004621/;6;32;38;
1505;Pieniążki edukacyjne /003648/;36;7;43;
1514;KOLEJKA /G2053/132140/;0;0;0;
1528;AUTO STRAŻ POŻARNA 30CM 8795745, 957450 ;3;41;44;
1539;DOMEK 3D  /MPC26506/                            265064;0;0;0;
1545;Wesoły dzbanek z melodią i klockami /ED2056C/000584/;0;0;0;
1546;LOKOMOTYWKA Z TOREM  /17526/                    614960;0;0;0;
1560;Gluty 24 szt. opakowanie 810554, 984115;170;1;171;
1564;Art. rozrywkowy glut jajko 12 szt. display 983903;-12;35;23;
1566;Pojazd Betoniarka /993462/;7;14;21;
1569;Pompony chirliderek 807455;3;36;39;
1580;GŁOWA DO CZESANIA /128242/;0;0;0;
1581;KAROCA NA BATERIE  /MPI48129/                   481297;0;0;0;
1587;LALKA SZMACIANKA 30CM. /PG2870/                 828700;2;30;32;
1588;Lalka Szmacianka Mała /819647/;13;0;13;
1592;"KOLEJKA ""SZCZĘŚLIWY POCIĄG"" B/O. /G048689/      945291";0;6;6;
1594;AUTO BETONIARKA /91956/NC  KLOSZ                991956;0;0;0;
1605;Torebka z akcesoriami 122011;2;22;24;
1608;AUTO WYŚCIGOWE 303056;0;0;0;
1609;TRUCK LAWETA + 4 AUTKA BUDOWL. /926072/         260729;0;0;0;
1617;PISTOLET TRANSFORMER /K8965/5                   158965;6;0;6;
1619;JEEP + 2PRZYCZEPY Z DINOZAURAMI /44647/NC       244647;0;0;0;
1629;AUTO 22CM. POGOTOWIE  /181632/    KLOSZ         816320;0;0;0;
1630;SAMOLOT NA BATERIE-PODWIESZANY /MPB80650/       806502;0;39;39;
1633;PISTOLET NA BAŃKI W FOLII /63473/               963473;17;0;17;
1638;PRALKA /ZR3216/960704/;1;21;22;
1646;BATERIA R03-OKTAN   X4                          170010;111;8;119;
1647;Sprężyna 967587;41;360;401;
1654;Gra zręcznościowa krzesła 36 el. 997191;-1;36;35;
1656;PRALKA NO.3117 NA BATERIE ŚW/DZW./G012098/      908470;0;0;0;
1660;TRANSFORMER AUTO WYŚCIGOWE /MPI54590/           545906;0;0;0;
1665;Gra w Kości /800044/;6;20;26;
1673;Badminton134816;20;20;40;
1676;Renifer /142986/;0;0;0;
1678;Jelonek /144164/;0;1;1;
1679;LATAJĄCA BILA 300543;12;9;21;
1681;Flet plastikowy 954002;0;49;49;
1688;Bałwan /136350/;0;1;1;
1689;Myszki nakręcane 12 szt. box 809800;-0.333300000000008;132.3333;132;
1694;NOSIDŁO 30CM. Z POŚCIELĄ /LA9910B/X             417951;0;0;0;
1697;Klocki - Sluban Policja (45 el.) /G032564/965572/;0;27;27;
1708;AUTO ŚMIECIARKA 30CM. /MKE127525/KLOSZ    91840,275257;0;0;0;
1709;ZEST.POLICYJNY+KAMIZELKA,KASK/66118/SIATKA      661187;0;0;0;
1717;KIEROWNICA DUŻA Z LICZNIKIEM /384576/           845762;26;48;74;
1719;KOLEJKA Z TOREM B/O. /014009/                   618517;1;1;2;
1724;PCHEŁKI /NAKŁON/   X6                           800105;0;0;0;
1729;CIASTOLINA - ZESTAW /G044331/             40289,618357;0;0;0;
1730;CIASTOLINA 4 POJEMNIKI /G060434/                958178;0;0;0;
1734;CIASTOLINA 6 POJEMNIKÓW WKSZ. /025735/          621302;4;1;5;
1735;Szachy + Warcaby 2 w 1   J. Polski   /814293/;0;12;12;
1743;Traktor wielki z łyżką 960465;0;12;12;
1747;KOMBAJN HARVESTER MAŁY-ZBOŻE /2500002/    00026,500004;0;0;0;
1757;TIR LAWETA + 5 AUTEK /92793/NC                  992793;0;0;0;
1782;CIĘŻARÓWKA CYSTERNA /93295/NC                   993295;-8;27;19;
1784;Robot wojownik display 12 399601;14;0;14;
1788;AUTO POLICYJNE 25X16CM. /ZM648/  KLOSZ          070813;0;12;12;
1791;MIKROFON B/O. CZARNY  NO.1319A                  293607;1;0;1;
1799;CZOŁG NA RADIO  /MPB75435/                      754353;0;2;2;
1801;Kalkulator /889855/;4;20;24;
1805;ZESTAW BOKSERSKI MNJ.  /261799/                 617995;10;5;15;
1809;MOTOR COOPER ŚW./DZW. /TG363197/  WOREK         876632;0;0;0;
1815;AUTKO 17CM W WORKU  /MPG42500/                  425000;12;13;25;
1835;Kolejka, światło, b.o /003240/;2;0;2;
1842;FLET DREWNIANY /U341/                           113293;0;0;0;
1845;PIRAMIDA /KACZOR,PAJACYK/   HEM                 002059;16;0;16;
1852;KARETA MNJ.+ KONIK,LALECZKA /MK4948884/   48882,488848;14;4;18;
1855;LALKA + 30  SUKIENEK  /034956/                  349560;0;0;0;
1856;Pistolet w pudełku /993721/;0;47;47;
1859;Piłka przeźroczysta z buźka 6.5 cm 301243;0;63;63;
1863;Zestaw Walizka - Narzędzia 18 elementów 305487;0;6;6;
1866;"LALKA 11""  ""SPARKIE""  225877";4;43;47;
1876;HELIKOPTER - NACIĄG SZNUREK  /015766/           609058;9;16;25;
1888;PARKING POLIC.Z AUTKAMI NO.660-76 /G057152      958352;5;2;7;
1896;"WALKIE TALKIE ""POLICE"" /MPG56713/               567137";0;0;0;
1902;Sznurki do wózka , 4 wz. /033566/;10;0;10;
1914;Zestaw do robienia baniek 964838;0;36;36;
1932;Kolejka na baterie /G057166/960140/;2;8;10;
1936;Traktor z maszyną rolniczą 24400, 530431, 903628;31;19;50;
1945;Zwierzak w jajku , display 12 szt. 399465;6;99;105;
1958;POMPKA DŁ.DO PIŁEK Z WĘZYKIEM /TAQT-0112/       003615;13;0;13;
1962;Warcaby & Młynek   802514;0;0;0;
1964;SPRZĄTACZKA ZESTAW WKSZ.W WORKU /027681/        616353;8;14;22;
1972;KOSTKA MAGICZNA ;74;0;74;
1985;BOBAS 30CM.- WEŁNIANE UBRANKO /1403/            870197;3;0;3;
1989;"KARTY PIOTRUŚ ""NAPIĘKNIEJSZE BAJKI /Z3264/      002488";3;2;5;
2012;WĘDKA+RYBKI - NEMO /ZR5823/                     013117;0;0;0;
2013;Tablet zabawka /808704/;23;0;23;
2017;WALKIE TALKIE-AUTA /HL361785/                   034445;0;0;0;
2027;TRAKTOR Z BECZKĄ     /MPC35632/ G045231   63252,943525;0;0;0;
2029;Kostka magiczna 926658;33;21;54;
2030;Zabawka piłka 992943;18;22;40;
2031;Kolejka na baterie 589cm /G075500/970965/;1;5;6;
2036;Klocki roboty (12 szt=display) 993278;8;26;34;
2043;TRUCK Z PRZYCZEPĄ MNJ.+ZWIERZĘTA /91901/NC      991901;0;0;0;
2044;PIANINKO-GRZYB GŁ. ZWIERZĄT /TG364067/          802665;0;0;0;
2045;Gitara w pudełku 878988 ;8;27;35;
2052;ZESTAW LEKARSKI /Q2718/129164/;2;0;2;
2063;MALOWIDŁA 4CZĘŚCI-KSIĘZYC  /MPD70396/           703962;0;0;0;
2069;AUTKO JEEP NO.336 /988698/  WOREK               886981;-36;70;34;
2073;PLAC ZABAW NA BLISTRZE/G048726/946212/;38;6;44;
2074;Gitara 719024;9;7;16;
2080;BALON PIŁKA /25SZT/                             830327;0;0;0;
2088;GWIZDEK PLASTIKOWY worek 12 sztuk393036;19;6;25;
2092;Piłka miękka x 12 szt. 961499;12;86;98;
2099;Telefon na baterie z nagrywaniem 806298;52;17;69;
2100;Okulary 136964;0;60;60;
2119;Pistolet z polskim modułem dźwiękowym 134472;0;0;0;
2121;Policja, światło, dźwięk, baterie załączone /394309/;0;3;3;
2124;Torebka kotek/piesek 12 szt. w foli 994688;9;99;108;
2132;MASZYNA BUDOWLANA NO.3316 /X1751/ MANITU 572394;1;17;18;
2141;AUTO NA BATERIE ŚW.3D  /TG372885/               801941;0;0;0;
2146;TRAKTOR Z CYSTERNA NO.1018-15 /433249/          332490;16;0;16;
2149;"PIŁKA SIATKOWA ""DURASOFT""   /V712/              110896";6;27;33;
2154;Bankowe jabłuszko - skarbonka / 000339/;9;53;62;
2164;Ciastolina dinozaury /814637/;6;16;22;
2177;Pistolet spłonka czarny /8392491,924913,968324;97;147;244;
2178;PISTOLET NA SPŁONKĘ Z LUNETĄ/ WOREK 63404,006725 218174;121;148;269;
2179;KASA  Z DZWIĘKAMI B/O. NO.34440 /G1003/         109326;1;0;1;
2183;Pałka bańki, display 24 szt. 201163;56;66;122;
2186;TIR+PRZYCZ.+ ZWIERZĘTA/DINOZAURY /127,394/  993127,394;0;0;0;
2194;ŁUK 42CM +3 STRZAŁY /HL315307/ WOREK            035428;0;0;0;
2195;Art. rozrywkowy płyn galaktyczny  X48 925934;-10;220;210;
2198;JEEP 28CM. ŻÓŁTY   /93363/NC   KLOSZ            993363;1;6;7;
2202;TABLICA ZNIKOPIS SŁOŃ /220031/                  200319;0;0;0;
2209;JOJO ŚWIECĄCE /68584/;58;0;58;
2213;Pistolet do robienia baniek 808285;46;0;46;
2225;Auto policja przewrotka 302899;16;78;94;
2236;Auto Kopyrtek /874461/;29;0;29;
2249;Jajko magiczne 12 szt. display 802061;0;48;48;
2255;PIŁKA DO SKAKANIA METALIZ.2KOL.45CM 831441;3;24;27;
2258;Gra zręcznościowa - krzesła 18 el. 997177;3;33;36;
2274;TRAKTOR siewnik nawozu  /796840/;6;8;14;
2282;Domino układanie słów /814415/;1;17;18;
2296;Auto w skali 1:22 R/C 4W na baterie 960698;0;24;24;
2303;TRĄBKA ROWEROWA (METALIZOWANA) /PG1605/   16131,871095;-4;12;8;
2305;BRANSOLETKA LAMBADKA  X10                       00981;96;450;546;
2307;Traktor 6 wz. 5605722, 969789, 057228;0;50;50;
2315;TRAKTOR z prasą kostkującą/ 642732/;4;7;11;
2319;Zestaw Policja 927212;0;54;54;
2325;KUCHNIA ŚW/DZW. 63X45CM. /ZR661-51/             096691;0;0;0;
2333;ZESTAW NARZĘDZI  W PVC  /G060446/               958291;2;10;12;
2353;SIATKA DO PIŁKI X25;100;0;100;
2372;KLOCKI BOBO - 100 KM2                           306305;0;2;2;
2373;KLOCKI BOBO - 200 KM4                           306268;1;4;5;
2379;PISTOLET NA SPŁONKĘ ZŁOTY/SREBRNY 8392455, 63381,924555;63;277;340;
2402;Klocki - sluban miasto (105 el.) /G032471/955115/;2;18;20;
2407;KOPARKO - SPYCHACZ /SYP/  SIATKA                300217;2;0;2;
2422;AUTKO METAL WYŚCIGOWE 1:43 /Q2309/  PUD.        113514, 397010;4;91;95;
2431;KUCHNIA (SWIATŁO,DZWIĘK) NO.3151 /G014207/      908494;0;0;0;
2439;PISTOLET MASZ.SPŁONKA /276536/  BLIST.          765368;7;76;83;
2451;Konik flokowany rodzinka 800807/403473;50;45;95;
2452;TRAKTOR Z PRZYCZEPĄ +FIGURKI /3975048/         750849;17;5;22;
2466;GWIZDEK PIŁKA NOŻNA /12szt/;0;0;0;
2473;TACZKA /HEM/                                    005371;8;0;8;
2477;Kula grzechotka 398918;31;66;97;
2481;KUCHNIA WIELOFUNKCYJNA 100CM. /MR/        ;4;1;5;
2482;W-48 Kuchnia Wielofunkcyjna 100cm;0;1;1;
2484;KARABIN PUKAWKA CIEN.LUFA /MPA46350/      35089,463507;11;0;11;
2493;HUŚTAWKA DESKA /TOYS/;1;0;1;
2496;Lizak policyjny 136827;1;35;36;
2516;KLOCKI - sluban budowlane (212 el.) /G070891/;0;0;0;
2517;Samochód policja na baterie/MPH86705X/867053/;20;74;94;
2533;Bączek świecący 135912;0;0;0;
2536;Zestaw kuchenny na blistrze 995746;0;46;46;
2538;Plac zabaw blister 995630;5;25;30;
2546;POZYTYWKA LALECZKA   /G069647/                  963097;0;0;0;
2547;GRZECHOTKA z dźwiękiem /G078010/970828/;3;0;3;
2559;STRZELBA Z LUNETA NA STRZAŁKI /381962/ BC       819626;11;16;27;
2569;ŚMIGŁO ZE ŚWIATŁEM /Q1268/ BLISTER              101436;0;13;13;
2570;AUTO PRZEWROTKA NO.138 /N1-138/                 000892;17;1;18;
2576;Latawiec nietoperz 134953;20;11;31;
2580;Plac zabaw blister 995647;3;32;35;
2590;"LALKA 11"" SOFIA   /GO75530/                     966074";1;0;1;
2591;TRAKTORKI METALOWE Z MASZYNAMI, DISPLAY, 12 szt. /001444/;11;0;11;
2593;LALKA ŚPIEWAJACA Z AKCESORIAMI /KT6300F/        000747;0;0;0;
2598;Samochód terenowy r/c,ff, ładowarka /SA6144R/394804/;0;0;0;
2610;Lornetka135967;0;0;0;
2615;AUTO STRAŻ POŻ.38CM.RUCH.DRABINA /ZM381/  089709 68604;3;9;12;
2629;PIŁKA 45CM DO SKAKANIA Z KOLCAMI /PG1310/       816896;0;0;0;
2631;KOLEJKA /G1023/110353/;2;0;2;
2638;POMPKA DO PIŁEK IGŁA,WĘŻYK /SPPIE16006/         214187;11;0;11;
2642;Gra magnetyczna 2w1 /301465/ZRJT849/;2;57;59;
2643;Piłka winogronko chropowate /12 displ / 6 cm 307764;108;85;193;
2644;"PIŁKA SIATKOWA ""TONCHAN""  983354";8;8;16;
2645;KOLEJKA NA BATERIE /MPF62240/   BLIST.   622409;0;0;0;
2665;PRALKA Z AKCESORIAMI ŚW/DŹW /215153/ZR008-97A/;0;3;3;
2671;Zestaw policyjny 993844;24;0;24;
2674;Układanka gumki 810639;6;41;47;
2677;Auto laweta + 3 auta718221;2;17;19;
2682;MOTYLKI-MAGNESY  /K8889/5                       158880;-6;11;5;
2686;ZEST.WIĘKSZY Z SUSZARKĄ B/O.  /MPG51070/  10706,392816;14;0;14;
2698;TRAKTOR+PRZYCZEPA 53CM+ZWIERZ./FA0488-98/612456;8;8;16;
2701;Lalka 487629;7;25;32;
2702;LALKA 4 dzw: 14' /MPH8436/084399/;1;16;17;
2711;TRAKTOR PRZYCZ.3ZWIERZ.DOMOWE 750849, 244760;43;38;81;
2713;Robot wojownik display 12 szt. 392442;15;36;51;
2714;PISTOLET NA SPŁONKĘ NA KARCIE /276833/          768338;-17;216;199;
2715;Telefon dla dziewczynkiMPJ05322, 398697;32;125;157;
2730;ODKURZACZ ŚWIATŁO/DZWIĘK NO.3939 /G031831/      919124;2;0;2;
2738;"DOMEK Z LALKĄ 11,5"" /3089404/                   884048";1;0;1;
2739;Miecz na bańki mydlane 090310;48;216;264;
2740;Konik z akc. BOX 393562;0;0;0;
2741;TRAKTOREK Z URZĄDZENIEM-PRZÓD /210951/          109513;38;35;73;
2756;AUTO ŚMIECIARKA /MPJ02119/  KLOSZ               021196;0;0;0;
2760;Mata dziecięca /MPH35979X/359794/;0;4;4;
2766;Piesek chodzący czapeczka;25;0;25;
2785;DOMEK DLA LALEK 305700;-2;8;6;
2786;Pałka bańki 38 cm, display 24 398499;116;2;118;
2789;ZESTAW PIĘKNOŚCI NO.924  /G075518/  BC          972570;9;1;10;
2792;SUSZARKA NA BATERIE +AKC. /118275/ TORBA  18278,182753;18;15;33;
2795;DOMEK-PAŁAC+AKC. NO.CB888-9 ŚW.DZW. /Q2226      120727;0;0;0;
2801;Pistolet na kulki żelowe 964883;0;67;67;
2804;PISTOLET B/O.  J.POLSKI  /G083854/              970514;0;0;0;
2817;MIKROFON STOJĄCY B/O. NO.5867  /G057294/  60249,617923;0;0;0;
2824;CIĘŻARÓWKA Z KOPARKą 29CM. /596571/       65710,993318;11;4;15;
2835;WIERTARKA NA BATERIE /61424/              57189,961424;16;0;16;
2836;Gra zręcznościowa /397768,398093/;0;0;0;
2837;Miecz na bańki 064328;0;24;24;
2841;KOPARKA 45CM.  KLOSZ 48362,273440;1;16;17;
2852;Lalka + ubranka 008132;7;0;7;
2888;Pchanka ptak 399694;0;69;69;
2891;AUTO STRAŻ POŻ. 23CM 098134;6;41;47;
2904;"AUTO F/F ""EXCITER"" + ŁADOW. /HL259420/          029281";1;4;5;
2917;Miecz na bańki mydlane 112241;0;60;60;
2919;"ROBOT ""AMAZING"" 37CM.W BOXIE /TA90921/          001031";-1;1;0;
2921;ZESTAW STRAŻAK Z KASKIEM MNJ. /60212/P    60212,803280;5;22;27;
2922;Zestaw policyjny z kaskiem /G031415/      73600,8145937;0;29;29;
2926;GŁOWA DO CZESANIA-MUZYKA/ŚW. /009935/           619132;2;13;15;
2952;ZEST.RYCERSKI,TARCZA,MIECZE,NAPIERŚNIK/GAZ      958901;0;0;0;
2960;TRANSFORMER AUTO NO.328-8AB /MPI54592/    45920,094536;0;0;0;
2973;Lalka /995270/;16;9;25;
2978;Instrument muzyczny gitara 134021;3;13;16;
2999;"FIGURKA""EARTH TUTELARY"" NO.2011-13              909265";8;28;36;
3000;Tor wyścigowy /961134/;1;9;10;
3001;LATAWIEC DO MONTAŻU PLASTIKOWY /G029112/        955528;3;9;12;
3002;Kareta /963909/;1;21;22;
3003;Lotnisko /966092/;1;17;18;
3004;Zestaw kuchnia /965736/;0;6;6;
3005;Parking /967228/;4;14;18;
3006;KLOCKI - SLUBAN STRAŻ (175 el.) /G032497/ /973751/;0;0;0;
3007;Auto policja /963893/;20;5;25;
3008;Klocki dziewczęce + auto /Ta2016-16/ 005817/;10;115;125;
3009;Manitu /968942/;3;0;3;
3010;Samolot 959321;-72;900;828;
3015;LALKA 471964;0;0;0;
3016;KIEROWNICA B/O. ZWIERZATKA                      293744;3;1;4;
3017;Wiertarka na baterie w zestawie  /557602 /;5;0;5;
3019;KUSZA NA KARCIE 43X28CM. /92663/NC              992663;2;0;2;
3024;TRAKTOR Z KOMBAJNEM ZIEM./1018-21/62964/  62964,952978;0;0;0;
3031;TRAKTOR z przyczepą /993684/93684/;0;0;0;
3033;Pojazd z koparką 993455;5;0;5;
3043;TABLICA ZNIKOPIS Z MISIEM /346166/              461665;0;0;0;
3046;AUTO LAWETA + motor  TG219042/812916/;0;18;18;
3050;Brelok brązowy 815245;12;26;38;
3054;KARETA Z LALKĄ 28CM. /033303/                   333303;7;0;7;
3056;LALKA SZMACIANKA  J.POLSKI  /TG400737/810691/;-31;51;20;
3058;ŻYŁKA DO ZAPLATANIA /63930/                     963930;19;202;221;
3061;WÓZEK SKLEPOWY NA KARCIE /MPB44299/             442991;0;12;12;
3062;ROBOT KUCHENNY 2WZ. /MPB70864,68/            708646,84;8;0;8;
3064;BAŃKI-PŁYN O,5L 77164,962858, 08143;195;68;263;
3067;Klocki Sluban Lotnisko (121 el.) /G088169/;0;4;4;
3072;JEEP PICK-UP DUŻY /340028/   KLOSZ              400282;-7;7;0;
3087;ROBOT EARTH FACTORY /2011-3/ 225877;0;36;36;
3089;NARZĘDZIA+WIERTARKA W SKRZYNCE /MP23440T/       234404;12;0;12;
3090;Kula grzechotka 398901, 817300;118;193;311;
3100;Głowa Lalki, W.BOX /393074/;0;22;22;
3101;TRAKTOR  642374;6;0;6;
3102;Grzechotka, Gryzak - Żabka /395047/;10;7;17;
3103;Grzechotka, Gryzak - Słonik /395054/;2;12;14;
3104;Młotek edukacyjny, św, dźw /392282/;7;6;13;
3105;Klocki Wafle 50 el /0007887/;0;35;35;
3106;Lalka Dorotka mówiąca i śpiewająca po polsku /116775/;1;24;25;
3107;Kasa z kalkulatorem /131884/;2;1;3;
3108;Domek na baterie /117741/;0;0;0;
3109;Warsztat z masą plastyczną /130627/;1;0;1;
3110;Balony Happy Birthday 10szt /122844/;10;0;10;
3111;Balony metalic 20szt /122820/;0;19;19;
3112;Tablica magnetyczna /122387/;1;21;22;
3113;Organki dla malucha /128075/;0;0;0;
3114;Cukierek na baterie /134229/;2;5;7;
3115;Maszyna budowlana /113651/;6;0;6;
3116;Balony metalic 25 szt. /122837/;0;22;22;
3123;Przewrotka lokomotywa /062428/;40;22;62;
3124;Lalka /164907/;5;14;19;
3127;Jojo 871750;4;96;100;
3135;WÓZEK DLA LALEK /06486X/8064865/;2;0;2;
3148;Piłka na lince;208;60;268;
3154;Samochód przewrotka 776676;6;62;68;
3156;TRAKTOR z przyczepą + zwierzęta /155820/;0;0;0;
3161;PCHACZ SAMOLOT 117639;168;0;168;
3175;Laweta z autkami 398420;16;52;68;
3181;Lalka syrenka 993004;69;36;105;
3183;ZESTAW NACZYŃ 963459;12;27;39;
3187;KARABIN PUKAWKA /7381224/  PEPESZA        47990,812244;90;75;165;
3195;TRAKTOR 598754;1;8;9;
3222;Karabin z dźwiękiem /969987/;0;0;0;
3230;Autka metal 5 sztuk 009337;8;5;13;
3236;Zestaw policyjny na blistrze 988878;0;78;78;
3248;KOLEJKA na baterie /TG220668/813586/;0;22;22;
3251;KOPARKA na radio /TG364150/ 803198/;6;1;7;
3266;TRAKTOR 485411;0;10;10;
3270;Autka 10 sztuk 008132;5;6;11;
3281;Malowidła dla lalek /803914/;7;17;24;
3292;RAKIETA DO TENISA W POKROWCU /PG3174/           831748;0;27;27;
3295;TRAKTOR 599119;1;0;1;
3309;Organy 962865;1;17;18;
3310;PIŁKA NOŻNA  301540;15;0;15;
3333;SPŁONKA POJEDYNCZA /CAP121/               262520;1589;967;2556;
3349;TRAKTOR z przyczepą+ zwierzęta 574108;24;40;64;
3350;Traktor z kosiarką polową  /834446/;0;0;0;
3357;SKRZYDŁA ANIOŁA  /ZRN11077/                     051348;0;0;0;
3359;KARTY PIOTRUŚ   X 20   (FAN)                    802019;18;120;138;
3360;KAJDANKI METAL  302707;1;15;16;
3361;Mebelki 135981;7;18;25;
3366;BĘBENEK DLA MALUCHA /306934/;6;12;18;
3383;Auto laweta z dużym autem /993301/;2;16;18;
3392;TRAKTOR Z MASZYNĄ-PRZÓD 248287,724375;30;72;102;
3396;TRAKTOR Z PŁUGIEM NA PRZYCZ./488-106/   611824/245422/;25;1;26;
3403;POCIĄG NA BATERIE PLATFORMA 684696;27;48;75;
3405;AUTKO JEEP 19CM.4KOL. /392525/                  925259;8;0;8;
3422;TRAKTOR 876601, 642640;9;19;28;
3430;TRAKTOR z maszyną rolniczą /TG218108/872108/;3;3;6;
3433;Autobusy SASC998-94/339142/;1;0;1;
3438;TRAKTOR z maszyną rolniczą /TG10131/872597/;5;6;11;
3442;WOJOWNIK 794833;5;0;5;
3456;Gitara /123919/;-3;13;10;
3464;PISTOLET ŚW/DZW. W PUDEŁKU /MPG40054/           872965;35;0;35;
3474;PCHANKA HELIKOPTER  /92308/;47;0;47;
3491;ZAMEK DLA LALEK MNJ. /G045136/                  948599;0;8;8;
3493;KLOCK-Sluban wojsko (121 el.) /G032513/;0;0;0;
3494;PIŁKA NOŻNA TRZYKOLOROWA /V706/                 110834;3;0;3;
3498;TRAKTOR 837416;10;0;10;
3510;PISTOLET NA BAŃKI, RYBA 390615;0;0;0;
3513;BALON WALENTYNKOWY Z NADRUKIEM /OPK.20SZT/      831607;1;0;1;
3521;EDU Biznes City;13;6;19;
3530;Piłka gumowa 994237;0;39;39;
3532;ZESTAW KOŃ 30CM.+K0NIK 18CM. /MPF63909/         639094;0;0;0;
3540;TRANSFORMER AUTO /MPB65229/G047336/   BC  45932,652291;7;0;7;
3543;AUTO SPORT CAR RADIO+ŁADOW. /HL88843/           021353;0;0;0;
3546;TRAKTOR 641742;10;0;10;
3569;GRA SKACZĄCE KAPELUSIKI /NAKŁON/                800112;3;9;12;
3576;Laleczki /TAT2068-19/393500/;0;0;0;
3588;EDU Chińczyk Warcaby   803177;1;0;1;
3598;TRAKTOR 157230, 572301;14;25;39;
3601;"""Zośka 55 mm 302585";0;42;42;
3614;KUCHNIA /6305531/ZR008-97A/;0;1;1;
3623;Mata 967402;0;9;9;
3633;Mikrofalówka /ZR3214N/6960315/;1;1;2;
3645;PAMIĘTNIK ZAMYKANY - PUDEŁKO /TG365130/         878650;9;0;9;
3668;"POCIĄG ""TRAIN EMLI"" B/O. /MPF62230/             622300";0;0;0;
3670;Piłka gumowa 994220;26;0;26;
3674;Zestaw Rycerski  /993653/;7;0;7;
3677;KULA SFERA MNJ. W FOLII  /MPA31959/             319590;50;53;103;
3678;KARUZELKA NAD ŁÓŻECZKO-PLUSZAKI /MPJ90125/      901252;5;0;5;
3680;KOMBAJN /92597X/;13;0;13;
3692;LEKARZ W PUDEŁKU  /MPJ88785/              86625,887853;8;0;8;
3698;Bobas w nosidle 396884;12;0;12;
3701;Malowidła dla lalek 985273;13;45;58;
3705;TRAKTOR+2MASZYNY BUDOWL.NA LAWECIE/433276/      332766;11;0;11;
3719;SANKI-ŁOPATA  /ST/;2;7;9;
3721;GRA ELEKTRONICZNA;0;0;0;
3726;PIESEK 967495;55;36;91;
3735;TOREBKA PLASTIK. ŚWIATŁO  /O1273/               101573;0;0;0;
3743;LALKA SYRENKA + AKC. /MPF42433/  PUD.           424331;1;0;1;
3749;KUCHNIA Z AKC./630548/ZR008-87A/;0;0;0;
3751;TRAKTOREK PRZYCZEPA,ZWIERZ. MNJ./451038/        510386;2;200;202;
3761;ZESTAW LEKARZ W PUDEŁKU /GO44793/MPB69234       939368;3;0;3;
3772;JEEP POLICJA NA BATERIE/MPD79972/ PUD.    97276,997276;2;29;31;
3774;TRAKTOR 837867;0;15;15;
3801;GRA GRZYBOBRANIE /NAKŁON/                       800167;1;9;10;
3803;DOMEK EDUKACYJNY B/O. /G348/                    093373;6;0;6;
3804;TRAKTOR 830822;0;23;23;
3816;"KOLEJKA ""CLASSIC TRAIN"" B/O. /MPH15173/         151732";4;2;6;
3824;Grzechotka 6 wzorów 811858;65;14;79;
3837;BIERKI /NAKŁON/                                 800129;2;51;53;
3843;ZESTAW RYCERSKI-2MIECZE TARCZA /GO44767/        939153;22;2;24;
3848;Lokomotywa, św, dźw. /396747/;7;0;7;
3876;LALKA CHŁOPAK  /TG364289/                       879107;0;0;0;
3894;AUTO BETONIARKA 31CM.  /91277/NC                991277;2;0;2;
3896;AUTO LAWETA Z AUTAMI BUDOWLANYMI 4 WZ. 25 CM /994025/;-1;27;26;
3902;TELEFON KOM.Z KORALIKAMI /TA7768/  2WZ.         000614;75;0;75;
3905;MYSZKA NAKRĘCANA MNJ. X 12SZT875642, 968935;301;88;389;
3911;PŁYWACZKI REKIN  /G057487,490/              956532,556;-55;77;22;
3925;BATERIA R6-OKTAN  X4                            171000;0;300;300;
3931;GŁOWA DO CZESANIA /MPD67470/TG364173/     74705,879565;7;0;7;
3942;ZESTAW LEKARSKI NA KARCIE  /G033164/923756;9;0;9;
3949;Blender /6960728/ZR3212M/;0;18;18;
3950;MOTOR Z KOSZEM NA BATERIE  /G040439/      50097,879183;9;0;9;
3953;HELIKOPTER;16;0;16;
3970;"BILARD ""MINI POOL""   /G031876/                  918615";0;0;0;
3975;KLOCKI BUS STRAŻ POŻ. 83EL. NO.8057       34636,960595;3;0;3;
3995;PIANINKO-DOMEK GŁ.ZWIERZĄT  /TG364068/          802672;4;0;4;
4001;Plastelina 5 kubków 004551;0;35;35;
4002;Karabin 973929;0;0;0;
4004;Auto 742939;0;0;0;
4005;Zestaw policja 654870;0;0;0;
4006;Traktor z przyczepą + zwierzęta /139883/;5;0;5;
4007;Karabin pukawka/ 479020,963213/;7;44;51;
4008;PIESEK FLOKOWANY KIWACZEK /12 szt / BOX 809817;26;12;38;
4009;PIESEK FLOKOWANY KIWACZEK /48 szt / BOX   809855;18;135;153;
4010;Holownik w worku 006258;20;19;39;
4011;Samochód holownik 921284;0;0;0;
4012;Auto sportowe 000744;2;1;3;
4013;Transrobot - motor ze światłem 003950;0;0;0;
4014;Płaszcz przeciwdeszczowy;3;0;3;
4015;Malowidła dla lalek 873501;2;44;46;
4018;Telefon na baterie 815153;29;29;58;
4020;Lalka w zestawie    033021;0;0;0;
4021;Lalka w zestawie 034554;22;0;22;
4022;Samochód ze światłem i dźwiękiem   /015973/;0;17;17;
4023;KLOCKI AUTO POLIC.88EL.(B800) /G032477/         954842;5;20;25;
4024;Klocki - Sluban Policja (45 el.) /954835/;0;13;13;
4025;Klocki - Sluban Formuła 1 ( 63 el.) /955153/;0;29;29;
4026;Klocki - Sluban Straż (118el.) /954729/;2;14;16;
4027;Kareta dla lalek /948186/;0;5;5;
4028;Zestaw Narzędzi - Krzesełko /978886/;0;3;3;
4029;Klocki - Sluban Farma (110el.) /973928/;0;14;14;
4032;Lalka z dzieckiem + akc. /576836/;13;0;13;
4033;GITARA 992731;4;7;11;
4034;Lalka /130961/;14;0;14;
4035;Lalka 6 szt. display 996255;0;0;0;
4037;Lalka + akc.  /537734/;0;0;0;
4043;KACZUSZKA+MAŁA-PISZCZKI /6801/                  744028;2;10;12;
4044;DINOZAURY MIĘKKIE 960223;6;0;6;
4050;Maszyna do szycia  /118892, 303025/;3;13;16;
4051;Mikser  /118403/;0;4;4;
4052;Mikser /118007/;1;3;4;
4053;Odkurzacz /121953/;0;0;0;
4054;Mata na baterie /132362/;3;6;9;
4055;Gra piłka nożna /125821/;-2;11;9;
4056;Koń dla Barbie /109357/;1;32;33;
4057;Koń dla Barbie /109340/;3;0;3;
4058;Lalka Dorotka szmacianka śpiewa i mówi po polsku  /109661/;0;5;5;
4059;Lalka Dorotka szmacianka śpiewa i mówi po polsku  /109678/;0;2;2;
4060;Lalka Dorotka szmacianka śpiewa i mówi po polsku  /105960/;2;0;2;
4061;Lalka Dorotka szmacianka śpiewa i mówi po polsku  /106660/;3;0;3;
4062;Lalka Dorotka szmacianka śpiewa i mówi po polsku  /106622/;0;0;0;
4063;Karty do gry 54 listki /121226/;0;4;4;
4064;Karty 24 listki  /000538/;0;1;1;
4065;Tor Dinozaur  /086190/;0;2;2;
4066;Zestaw kuchenny  /986065/;3;13;16;
4069;Klocki drewniane /JENGA/TG18485/870913/;2;6;8;
4070;Klocki - sluban straż (136 el.) 988298;0;18;18;
4072;MYSZKA NAKRĘCANA WKSZ.  OP.X1  /1489419/        894193;1;0;1;
4080;BAŃKI-PŁYN 1L. KANIST 62841,70302,962841, 08136;78;60;138;
4084;Zwierzęta Bimbom 136438;1;63;64;
4088;Zwierzak z akcesoriami w worku 399779;2;51;53;
4089;Piłka na sprężynie /815122/;0;0;0;
4096;GARAŻ /131600/;4;0;4;
4097;Zabawka latająca świecąca 135301;0;95;95;
4106;PISTOLET NA BATERIE 805949;16;0;16;
4152;Zestaw policja /431471/;-18;27;9;
4163;Auto laweta + 6 autek 959029;0;35;35;
4168;Zestaw do gry 994473;0;21;21;
4176;KLOCKI Z FIGURKĄ /302141/zrxp90010n/;0;11;11;
4177;Lokomotywa na baterie /461483/;0;0;0;
4196;PISTOLET NA WODę 28CM /2299                     822992;-2;2;0;
4198;PISTOLET NA WODę MAłY;0;2;2;
4199;Lalka dźwiękowa masza 812787;145;58;203;
4200;ZABAWKA FIGURKA;21;0;21;
4201;ZABAWKA RÓZGA;40;0;40;
4202;PLAC ZABAW - blister /G048725/946229/;40;0;40;
4203;AUTO 32CM                                       992212;3;3;6;
4204;POJAZD KłAD                                     993509;1;0;1;
4205;AUTO POLICJA                                    993325;21;0;21;
4206;HELIKOPTER NA BATERIE                        993424;6;35;41;
4207;KOPARKA                                         993165;13;3;16;
4208;POJAZD ROZKRęCANY                               993530;0;1;1;
4209;Młotek piszczący 992915,919236, 879213;43;158;201;
4210;ZESTAW POLICYJNY                                992618;4;0;4;
4211;Helikopter z dźwiękiem 93479/993479/;11;0;11;
4212;Koparka 93554/993554/;13;0;13;
4215;ZESTAW DO PIASKU DUżY                           300132;1;0;1;
4234;PłYN DO BANIEK;19;14;33;
4237;PISTOLET SYGNAłOWY;11;0;11;
4243;KOSZYKÓWKA;6;16;22;
4250;Fryzjer plastikowy zestaw 107082, 510706;28;39;67;
4251;MASKOTKA PIES;26;0;26;
4253;MASKOTKA WIEWIÓR;18;0;18;
4254;MASKOTKA PINGWIN;10;0;10;
4256;MASKOTKA SID;10;0;10;
4257;Auto 93349 /993479/;4;6;10;
4258;MASKOTKA MINI;18;0;18;
4259;PIłKA;131;0;131;
4260;ZABAWKA PIERśCIONEK;36;0;36;
4261;KOSZYKÓWKA;0;19;19;
4262;MIECZ NA BATERIE;24;91;115;
4263;ZESTAW KUCHENNY;0;0;0;
4264;KULKI GRANAT;4;0;4;
4265;ZESTAW KUCHENNY;2;0;2;
4266;ZESTAW PIęKNOśCI;8;52;60;
4267;ZESTAW PIęKNOśCI Z BUCIKAMI;0;17;17;
4268;ZESTAW PIęKNOśCI;0;1;1;
4269;ROBOT KUCHENNY NA BATERIE;-6;7;1;
4270;ZESTAW BOKSERSKI;7;8;15;
4271;ZESTAW PIęKNOśCI;12;2;14;
4272;PROJEKTOR NA BATERIE;2;10;12;
4273;ZESTAW SAMOCHODÓW;0;0;0;
4274;KOLEJKA z torami /305074/;4;51;55;
4275;GITARA;12;0;12;
4276;KUSZA;5;10;15;
4277;Motor 93745 /993745/;9;36;45;
4278;GRA RYBKI;2;0;2;
4279;ZESTAW DO BANIEK;10;1;11;
4280;Bąk duży przezr.;24;39;63;
4281;GRA RYBKI  111695;30;6;36;
4282;PIŁA DUŻA NA BATERIE  /G039744/                 933892;2;6;8;
4283;Walec 960274;22;10;32;
4284;TRAKTOR siewnik nawozu;10;0;10;
4285;Pistolet w pudełku 93646 /993646/;6;23;29;
4286;KULKI;49;1;50;
4287;KULKI;22;0;22;
4288;PTASZEK W KLATCE;8;0;8;
4289;TOREBKA;31;0;31;
4290;PCHACZ;5;0;5;
4291;PCHACZ;13;0;13;
4293;KARABIN;13;0;13;
4295;KARETKA;21;0;21;
4296;AUTO;11;0;11;
4297;Traktor z łyżką /968065/G045126/;0;13;13;
4298;Traktor z opryskiwaczem 900412, 968355;5;15;20;
4299;Traktor z wozem paszowym 964333;14;14;28;
4300;TRAKTOR;8;9;17;
4301;TRAKTOR;3;22;25;
4302;WIDLAK;8;8;16;
4303;LALKA /969222/;7;0;7;
4304;LALKA;3;0;3;
4305;Lalka ze skuterem/969246/;3;24;27;
4306;LALKA 969253;0;0;0;
4307;LALKA 969260;-3;27;24;
4308;LALKA 969277;3;0;3;
4309;TOREBKA;20;0;20;
4310;"""AUTA"" PICKUP 2WZ. /192    300346   ZM826-104-106";0;0;0;
4311;WÓZEK;1;0;1;
4312;PISTOLET NA STRZAłKI                            123650;24;0;24;
4313;"""AUTA"" SPORTOWE 2WZ. /192   300353  ZM826-105-107";0;0;0;
4314;TRAKTOR Z MODUłEM                              115808;5;14;19;
4315;TRAKTOR Z MODUłEM                              115846;1;22;23;
4316;TRAKTOR Z MODUłEM                              115815;1;52;53;
4317;TRAKTOR Z MODUłEM                              115792;10;12;22;
4318;TRAKTOR Z PRZYCZEPą                             119110;0;0;0;
4319;"""AUTA"" AUTO Z LAWETĄ 3WZ /72   300360 ZM826-108-109-110";1;14;15;
4320;KALEJDOSKOP                                     124138;0;0;0;
4321;WANNA 124121;5;3;8;
4322;Żaba          /12szt displ/24022;21;95;116;
4323;AUTO FRICTION /36 ZM388-09A 300087;0;0;0;
4324;HULAJNOGA                                       124275;1;0;1;
4325;ZESTAW POLICYJNY                                122509;-1;43;42;
4326;NACZYNIA W SIATCE                               123582;-7;35;28;
4327;ZESTAW LEKARSKI                                 123704;1;0;1;
4328;LALKA                                           119530;0;0;0;
4329;KARABIN NA BATERIE                              117093;5;13;18;
4330;Różdżka ze światłem 984160;12;0;12;
4331;PCHANKA PIRAMIDA                                118250;0;5;5;
4332;PIRAMIDA                                        120451;6;4;10;
4333;WYRZUTNIA POCISKÓW                              115105;6;107;113;
4334;Jajko dinozaura rosnące /12 szt disp/390899;2;35;37;
4335;KORONA śWIECąCA                                 113330;0;0;0;
4336;KONIK NA BLISTRZE                               106554;-2;3;1;
4337;BęBENEK                                         091867;28;0;28;
4338;BOBAS śPIEWAJąCY                                116782;3;30;33;
4339;Zestaw muzyczny 90126 /990126/;37;0;37;
4340;BOBAS DOROTKA ŚPIEWAJĄCA I MÓWIĄCA              116508;0;0;0;
4341;BOBAS DOROTKA ŚPIEWAJĄCA I MÓWIĄCA              116829;4;5;9;
4342;PISTOLET NA STRZAłKI                            124350;7;269;276;
4343;RÓŻDŻKA 124527;-26;82;56;
4344;TRAKTOR Z MODUłEM  115723;6;53;59;
4345;TRAKTOR Z MODUłEM                               115877;2;22;24;
4346;TRAKTOR Z MODUłEM                               115839;1;47;48;
4347;TRAKTOR /410546/;30;0;30;
4348;SUKIENKA DLA LALKI;2;0;2;
4349;UBRANKO DLA BOBASA;1;3;4;
4352;POCIąG NA BATERIE                               978503;12;50;62;
4353;PIESEK NA BATERIE 978275;-5;44;39;
4354;KLOCKI SLUBAN STRAż                            973706;0;0;0;
4355;KARTY DO GRY /302783/;0;0;0;
4356;PIłKA DO SKAKANIA  967446/Z3735/;5;0;5;
4357;ŁOPATKA                                         000895;17;78;95;
4358;KLOCKI K2 MAłE                                  000895;6;2;8;
4359;KOMPLET KONIECZYNKA                           000833;15;0;15;
4360;KOMPLET KONIECZYNKA RÓŻ                         000833;1;0;1;
4361;KOMPLET KONIECZYNKA                             000857;15;0;15;
4363;KUFEREK                                         002202;0;1;1;
4365;ROBOT 960250;28;16;44;
4367;łAPACZ                                          63060;32;0;32;
4368;BRAMKA 120X65                                   69345;1;0;1;
4370;PISTOLET RYBA                                  68720;2;0;2;
4371;TRAKTOR KOPARKA                             64548;11;0;11;
4372;KOMBAJN                                      69796;11;0;11;
4373;TRAKTOR WIELKI DO SIANA                        68171;10;0;10;
4374;KREDA DO ASFALTU                                68768;1;48;49;
4375;TRAKTOR M Z OPRYSKIWACZEM I łYżKą  /60755/;16;0;16;
4376;TRAKTOR WIELKI ROZRZUTNIK                        62650;9;0;9;
4377;Bąk duży malowany;73;39;112;
4378;Traktor średni wężownica083767;12;12;24;
4379;ZESTAW WOJSKOWY                                  63091;-10;28;18;
4380;PłYN DO BANIEK 2L                              68775;7;0;7;
4381;PISTOLET Z DźWIęKIEM                             69840;25;0;25;
4382;PISTOLET Z BAńKAMI                               68683;25;24;49;
4383;ZESTAW RAKIET                                   69925;5;25;30;
4384;ZESTAW POLICJA                                   68904;22;11;33;
4386;TRAKTOR WIELKI PRZYCZEPA                         68188;12;0;12;
4387;PISTOLET NA STRZAłKI                             64579;4;0;4;
4388;Bańki;20.2333;0.4667;20.7;
4389;KOLEJKA+3 WAGONY  /211988, 960773/;11;19;30;
4390;ZESTAW LEKARSKI                                 215146;0;0;0;
4391;TELEFONIK NA BATERIE                            110212;19;1;20;
4392;TABLICA MULTIMUZYCZNA  070301;6;47;53;
4393;LORNETKA 000876;20;0;20;
4394;LALKA PARKA W WORKU                             113060;2;0;2;
4395;LALKA PARKA W WORKU                             113070;6;0;6;
4396;Robot 161250;12;29;41;
4397;FIGURKA ROBOT                                   212671;-1;1;0;
4398;Robot 161274;13;21;34;
4399;TRANSROBOT 209930;21;20;41;
4400;ŻELAZKO /211704/;12;0;12;
4401;GLUTY części ciała  /48szt displ/807615, 870982;281;183;464;
4402;GLUTY oko /48szt display/807639;10;278;288;
4404;KARABIN NA KULKI  /876977/;10;0;10;
4405;SAMOLOT NA BATERIE                             871569;8;0;8;
4406;MłOTEK PISZCZąCY                                879220;20;50;70;
4407;MLOTEK PISZCZąCY                              879213;0;0;0;
4408;KARABIN NA STRZAłKI  /879879/;45;38;83;
4409;KARABIN TERKOTKA                               879886\;47;0;47;
4410;PIłKA GUMOWA                                   878292;7;124;131;
4411;KARTY DO GRY   /302141,878315/;27;88;115;
4412;MIKROFON ECHO                                  802795;6;28;34;
4413;MIecz na bańki mydlane 112265;0;48;48;
4414;KARABIN NA KULKI                                801644;12;0;12;
4415;TELEFON NA BATERIE                              802443;31;40;71;
4416;BIEDRONKA NA BATERIE                          804706;11;0;11;
4417;TELEFON805970, 964876;18;42;60;
4419;KARABIN HUKOWY                                  806144;-1;47;46;
4420;BUTLA GAZOWA GLUTY  /24 w op/                            806953;113;0;113;
4421;WIATRAK BROKATOWY                              807790;72;55;127;
4422;Świderek plastikowy 12szt /808155/;84;0;84;
4423;ŚWIDEREK PLASTIKOWY  /12szt/ 806892, 871170;26;11;37;
4424;śWIDEREK PLASTIKOWY                           808100;12;0;12;
4425;BATERIA PANASONIC R03/TRAY (10sztuk);-112;470;358;
4427;KOMBAJN                                        005087;8;8;16;
4429;TRAKTOR siewnik nawozu 006244;9;0;9;
4431;TRAKTOR z pługiem /000075/;0;0;0;
4433;AUTO POLICYJNE                                009344;2;14;16;
4434;POCIąG NA BATERIE                               009115;1;0;1;
4435;MOTOCYKL                                        008804;3;0;3;
4436;ZWIERZąTKO NAKRęCANE                            008439;0;0;0;
4437;TRąBKA Z FLAGą /008019/;52;83;135;
4438;MINI GOLF                                       008774;11;0;11;
4440;ROBOT NA BLISTRZE 009214;4;20;24;
4441;KONIK ZEWSTAW                                   006589;9;0;9;
4442;LALKA SZMACIANKA                               009375;5;0;5;
4444;LALKA                                          000204;2;0;2;
4447;PISTOLET NA STRZAłKI                            006473;36;57;93;
4450;Gitara mała 962841;5;47;52;
4451;Bateria Panasonic R3L Alkaline;206;58;264;
4452;BATERIA PANASONIC R6L ALKALINE;252;267;519;
4453;TRAKTOR                                         962643;5;0;5;
4456;PłYN DO BANIEK 0,5                              011494;39;0;39;
4457;SKAKANKA Z LICZNIKIEM                           830635;34;48;82;
4458;Kombajn378566, 874508;29;56;85;
4459;ZESTAW POLICYJNY 632378;50;226;276;
4460;ZESTAW POLICYJNY                                293005;0;0;0;
4462;UKłADANKA METALOWA                              463286;0;63;63;
4463;KARABIN                                         28821;11;0;11;
4464;Sprężyna ze światłem 393210;32;25;57;
4465;PCHANKA KÓŁKO  661934;24;46;70;
4469;PISTOLET SPRężYNOWY;0;0;0;
4477;CZOłG                                          4231422;14;0;14;
4478;TRAKTOR   /483939/;22;0;22;
4479;TRAKTOR z przyczepą + zwierzęta /4839661/;0;0;0;
4480;AUTO;20;0;20;
4481;ZESTAW MUZYCZNY                                211496;20;0;20;
4482;Zestaw muzyczny 417215, 60427;22;61;83;
4483;AUTO                                           700141;2;0;2;
4484;TRAKTOR  41128025;67;205;272;
4485;TRAKTOR 128926;7;146;153;
4486;Traktor z belownicą  /9259956/;29;32;61;
4487;TRAKTOR 764156;6;0;6;
4488;ZESTAW POLICYJNY                           691316;0;0;0;
4489;TRAKTOR z łyżką /724375/                            ;0;0;0;
4490;QUAD   /784412/;6;0;6;
4491;AUTO /7485516/;0;0;0;
4492;Cymbałki341645;8;35;43;
4493;WRÓŻKA   /979663/;0;0;0;
4494;TRAKTOR                                         269661;4;30;34;
4495;AUTO /535185/;10;0;10;
4496;TRAKTOR   /701454/;0;0;0;
4497;AUTO/562752/;8;2;10;
4498;AUTO  / 731466/;7;6;13;
4499;Śmieciarka           993172,  3223665;6;19;25;
4501;AUTO 290340;17;51;68;
4502;AUTO   /712809/;3;0;3;
4504;ZESTAW RAKIETEK                               984595;8;0;8;
4505;ZABAWKA MUZYCZNA    /254565/;0;0;0;
4506;AUTO    /698040/;0;0;0;
4508;STRAŻ POŻARNA  / 8797473/;1;10;11;
4509;RAKIETKI   /348332/;4;2;6;
4510;GRA RYBKI    /803864/;12;4;16;
4511;LALKA  /064143/;0;0;0;
4512;ZESTAW LEKARZ                                  546718;0;0;0;
4513;TRAKTOR z pługiem /842112/             ;4;13;17;
4514;PISTOLET + 10 strzałek /6323748/;28;0;28;
4515;AUTO /715495/;9;0;9;
4516;BANKI                                          8688432;3;0;3;
4518;TRAKTOR                                         764075;1;0;1;
4519;TRAKTOR  /764192/;3;0;3;
4520;TRAKTOR  belownica  643630;13;28;41;
4521;AUTO /895757/;12;0;12;
4522;BAńKI KACZKA                                     68690;8;0;8;
4525;maszyma budowlana 51551;12;0;12;
4526;Traktor;2;2;4;
4527;Maszyna budowlana;5;0;5;
4528;Aparat do robienia baniek;0;0;0;
4529;Rurka do nurkowania;0;59;59;
4530;Okulary do pływania;24;8;32;
4532;Auto policja z napędem światło + dźwięk;0;0;0;
4533;Auto pogotowie z napędem /015935/;-6;27;21;
4534;Akcesoria dla lalek - buty 809022, 989790;51;27;78;
4535;Zestaw kuchenny;4;7;11;
4536;Zestaw Rycerski;0;0;0;
4537;Liczydło;1;15;16;
4538;Liczydło mini;2;4;6;
4539;Okulary 12szt. na blistrze;15;0;15;
4540;Piłka plażowa gumowa;27;0;27;
4541;Okulary do pływania;1;4;5;
4542;Brelok z latarką;27;91;118;
4543;Kula magiczna;73;20;93;
4544;Skakanka ;22;1;23;
45450;Zestaw do tenisa;0;0;0;
4546;Klocki dom;1;0;1;
4547;Miecze z bańkami;16.25;0.0001;16.2501;
4548;Miecz z bańkami;17.2914;6.5003;23.7917;
4549;Okulary olbrzyma 69833;12.7499;24.5;37.2499;
4550;Karabin;14;27;41;
5000;Piłeczki do tenisa;0;83;83;
5001;Auto laweta;-1;19;18;
5002;Malowidła dla lalek;17;0;17;
5003;Malowidła dla lalek 875543;2;0;2;
5004;Auto straz na baterie/TG206911/873525/;-1;17;16;
5005;Gitara;7;0;7;
5006;Zestaw łuk z karabinem;0;0;0;
5007;Zestaw plac zabaw;1;9;10;
5008;Trąbka do roweru;0;0;0;
5009;Trąbka do roweru;0;0;0;
5010;Piłka miękka;0;0;0;
5011;Kalkulator 814323;1;61;62;
5012;Pistolet na baterie j. polski;5;5;10;
5013;Biedronka na baterie;0;0;0;
5014;Pszczółka przewrotka;0;0;0;
5015;Lalka syrenka światło;0;0;0;
5016;Układanka klocki;16;6;22;
5017;Układanka klocki;4;38;42;
5018;Auto straz na baterie;9;9;18;
5019;Gitara w etui;0;1;1;
5020;Gitara w etui;1;0;1;
5021;Gluty-czesci ciała;0;0;0;
5022;Gluty oko;0;0;0;
5023;Gra tetris;0;0;0;
5024;Kusza drewnina;12;0;12;
5025;Samolot na baterie;9;10;19;
5026;Pistolet na baterie j.polski 877332;27;0;27;
5027;Komplet zamek 8 elementów z młynkiem;6;0;6;
5028;Komplet kwiatek 5 elementów z młynkiem;5;1;6;
5029;Młynek do piasku;0;0;0;
5030;Komplet kwiatek 4 elementy;0;1;1;
5031;Komplet zamek 5 elementów z młynkiem;6;0;6;
5032;Komplet zamek 4 elementy;5;7;12;
5033;Komplet kogucik 3 elementy;2;0;2;
5034;Komplet koniczynka 4 elementy;7;0;7;
5035;Taczka;4;0;4;
5042;Taczka;1;0;1;
5046;Auto;0;0;0;
5047;Auto;4;1;5;
5048;Auto;0;23;23;
5049;Traktor;0;0;0;
5050;Auto   /816277/;12;0;12;
5051;Auto;10;0;10;
5052;Strzelba;0;1;1;
5053;Traktor z pługiem;0;0;0;
5054;Traktor;0;0;0;
5055;Traktor;0;2;2;
5056;Auto;0;1;1;
5057;Dzwig 247797;2;22;24;
5058;Kombajn 489390;23;0;23;
5059;Traktor 060305;2;9;11;
5060;Traktor 060398;5;15;20;
5061;Traktor z przyczepą /771587/;0;0;0;
5062;Traktor 222813;6;1;7;
5063;Traktor  z wozem paszowym 222639;3;1;4;
5064;Traktor 044632;0;0;0;
5065;Helikopter 025531;4;19;23;
5066;Traktor z pługiem/692299/;2;3;5;
5067;Traktor 843553;12;31;43;
5068;Traktor 098596;-4;24;20;
5069;Zestaw lekarz 989049;0;48;48;
5070;Traktor z kosiarką polową 012756, 964524 ;4;10;14;
5071;Auto 197749;1;52;53;
5072;Auto198012;1;53;54;
5073;Robot 572644;0;0;0;
5074;Traktor z siewnikiem nawozu /604614/;9;16;25;
5075;Traktor 797472;11;6;17;
5076;Zestaw Strazak 885255;0;0;0;
5077;Traktor 049716;0;0;0;
5078;Traktor 643814/G052727/;9;18;27;
5079;Traktor 412250;0;0;0;
5080;Traktor z belownicą 412076;1;31;32;
5081;Traktor 411086;5;29;34;
5083;Piłeczka;33;0;33;
5085;Kaczor z dzwonkiem;1;0;1;
5087;Motyl;10;0;10;
5088;W-16 Piramida duze kulki;18;0;18;
5090;W-13 Piramida małe kulki;23;0;23;
5091;W-15 Piramida puzzle;10;0;10;
5097;Dinozaur z jajkami;0;20;20;
5099;Nakręcanki-zolw  220027;0;0;0;
5100;Nakrecanki- krokoldyl 220034;3;1;4;
5101;Nakrecanki-hipopotam   220065;-1;6;5;
5102;Bilard   212961;2;4;6;
5103;Pistolet   212923;10;0;10;
5104;Pistolet   301595;59;0;59;
5105;Badminton   301113;0;0;0;
5106;Tablica magnetyczna   304886/877738/;12;21;33;
5107;Robot nowe legendy policji   960681;21;0;21;
5108;Robot legendy policji  960636;5;0;5;
5109;Gra wodna   301311;3;105;108;
5110;PSP Tetris 302226/004612/;0;0;0;
5111;Gra wodna kierownica 301502;-10;312;302;
5112;Gra wodna   301496;0;0;0;
5113;Gra wodna rybki  /8 na blistrze/ 301328 ;30;98;128;
5114;Zestaw lekarz  - walizka   302912;0;0;0;
5115;Walkie talkie   304688;1;19;20;
5116;Znikopis   ;0;6;6;
5117;Kula sfera   301267;0;0;0;
5118;Samolot na baterie 215184;18;25;43;
5120;Wiatrak 23cm wielokolorowy;93;82;175;
5121;Wiatrak 20cm wielokolorowy;89;72;161;
5122;Spiner;72;0;72;
5125;Wiatrak 25cm;145;28;173;
5128;Lotki 3 szt;13;64;77;
5129;Kreda 112869;12;6;18;
5130;Wiertarka na baterie 091744, 302851;33;38;71;
5131;2 koniki + zagroda /25104/;0;0;0;
5132;Skakanka sznurkowa 101474;10;37;47;
5133;Zwierzęta farm 082797;0;0;0;
5134;Ptak na baterie ;16;0;16;
5135;Robot na blistrze;0;0;0;
5136;Auto lampart na baterie;7;10;17;
5137;Zabawka dla malucha;15;21;36;
5138;Zestaw kuchenny na blistrze;0;0;0;
5139;Świderek;0;0;0;
5140;Konie flokowane;25;0;25;
5141;Robot na blistrze 870777;24;26;50;
5142;Zestaw karabin z łukiem 872856;2;7;9;
5143;Pistolet na kulki wodne /TG379821/;0;0;0;
5144;Piłka nożna 110773;0;0;0;
5145;Piłka nożna 110858;0;0;0;
5146;Piłka nożna 110872;0;0;0;
5147;Kulki wodne 879459;175;74;249;
5148;Zestaw księżniczka 801439;0;0;0;
5149;Lalka bobas j.polski 877370;0;0;0;
5150;Malowidła dla lalek 805512;37;19;56;
5151;Sprężyna tęczowa 808650;0;0;0;
5152;Mirofon na baterie 808957;0;0;0;
5153;Malowidła dla lalek 809077;0;0;0;
5154;Malowidła dla lalek 809060;0;0;0;
5155;Żel pierdzący 24 szt. display 870999;51;114;165;
5156;Trąbka do roweru;0;0;0;
5157;Tarcza rzutki magnetyczne 301397;3;7;10;
5158;Nakręcanki 303575;-31;45;14;
5159;Bańki - pałka 22 cm + bębenek z kulkami x12308693;7;35;42;
5160;Płyn do baniek 1l;21;2;23;
5161;Nakręcanka myszka /12szt displ/302905, 67247;8;144;152;
5162;Gra magnetyczna złap motyla 301014;1;0;1;
5163;Litery i cyfry magnetyczne 304060;3;38;41;
5164;Superbohaterowie/display 300100;0;0;0;
5165;Robot 993134;22;0;22;
5166;Karabin 993219;32;0;32;
5167;Koparka na kołach 992939,94049;-8;15;7;
5168;Zestaw piękności 993400;0;0;0;
5169;Strzelba 993905;3;0;3;
5170;Karabin 993585;75;0;75;
5171;TRAKTOR  z kosiarką roatacyjną 993691;0;0;0;
5172;Samochód ratunkowy 993639;4;0;4;
5173;Kostka magiczna 923794/810486/;126;120;246;
5174;Czołg z napędem 981121;-47;151;104;
5175;Art. rozrywkowe smoła (display 24 szt.);0;0;0;
5176;Zabawka samolot 001005;7;14;21;
5177;Tablica znikopis 003984;0;0;0;
5178;Zabawka puzzle  012269;2;0;2;
5179;Kolejka na baterie  027652;4;0;4;
5180;Lotki do kometki 035398;26;54;80;
5181;Traktor z napędem  034759;11;0;11;
5182;Traktor z napędem  034865;7;1;8;
5183;Zestaw gier plenerowych 303315;5;21;26;
5184;Piłka nożna satynowa metalizowana;9;8;17;
5185;Auto truck 304879;3;32;35;
5186;Bańki uśmiech /24szt displ/300871;81;180;261;
5187;Żaba na baterie 63992;0;0;0;
5188;Pistolet dźwiękowy 69963;104;0;104;
5189;Kosiarka z bańkami 60915;8;0;8;
5190;Kolejka + Tory 302134;0;34;34;
5191;Zestaw do golfa 301700;0;36;36;
5192;Zwierzęta Dinozaury 305135;2;45;47;
5194;Samochodzik metal, x24 003226;2;0;2;
5195;Metalowe samochodziki box x24 392091;13;11;24;
5196;Samochody metalowe pullback 393289;0;0;0;
5197;Samochód pod kloszem, św, dzw 392121;1;2;3;
5198;Auto holownik 30 cm, światło, dzwięk 392114;1;3;4;
5200;Koń flokowany TG364168/877288/;0;0;0;
5201;Zestaw kuchenny blister TG369820/802184/;3;37;40;
5203;Gluty insekty 24 szt. /806915;2;0;2;
5204;Auto /633036/;0;0;0;
5205;Auto /549353/;4;20;24;
5207;Traktor /0057069/;6;0;6;
5208;Traktor /455835/885728/;9;0;9;
5209;Traktor /797472/;6;0;6;
5210;Kombajn /745202/;8;0;8;
5211;Kombajn /936181/;4;8;12;
5212;Traktor /0085673/;5;7;12;
5213;Traktor /085499/;3;15;18;
5214;Traktor /085313/;6;12;18;
5215;Traktor /489198/;0;10;10;
5216;Traktor /965530/;2;0;2;
5217;Piła na baterie 807660;2;6;8;
5218;Pistolet żelowy 68096 , 305852;19;101;120;
5219;Pistolet żelowy 68133;34;7;41;
5220;Gra rybki /69758/;1;12;13;
5223;Lalka ze skrzydełkami /TG17527/;0;0;0;
5224;Pistolet na kulki wodne /TG400100/;21;0;21;
5227;Kula z kitą 964005;8;76;84;
5230;Auto laweta - truck quady   302998;4;5;9;
5231;Traktor z przyczepą /MA9022C/;9;0;9;
5234;Miecz piankowy (12 szt) ;7;25;32;
5235;Pistolet do robienia baniek /G062513/;15;0;15;
5236;Pistolet do robienia baniek /G068562/;43;0;43;
5237;Miecz na baterie /G075687/;9;0;9;
5238;Zestaw rycerski /G087914/;6;5;11;
5239;Maszyna rolnicza z przyczepą /G077917/;3;9;12;
5240;Maszyna budowlana /G089704/;5;67;72;
5242;Łuk na blistrze 981770;25;30;55;
5243;Pistolet na kulki w folii /GE00063/;34;0;34;
5244;Miecz piankowy (12 szt.);4;28;32;
5245;Pistolet na kulki w foli (laser,latarka) /GE00060/;20;0;20;
5246;Pistolet na kulki w folii /GE00066/;31;0;31;
5247;Pistolet na kulki pudełko(laser,latarka) /GE00077/;5;37;42;
5248;Królik Nina z szalem różowym 30cm /044655/;0;0;0;
5249;Pies Florek kremowy 20cm siedzący /040534/;0;0;0;
5250;Kolekcja Kropeczka - Słoń z kocykiem 21cm  /047144 /;1;0;1;
5251;Zając Kołtunek 31cm w sukience /047151/;1;2;3;
5252;Miś Szczepan 36cm   /044716 /;0;0;0;
5253;Miś popielek 28cm w sukience /047182/;0;4;4;
5254;Kolejkcja Silver - Królik 20cm  /045386/;0;1;1;
5255;Kolekcja Silver - Królik 30cm  / 045522 /;0;1;1;
5256;Kolekcja Silver - Miś 35cm  /045515/;0;0;0;
5257;Kolekcja Silver - Miś 25cm  /045379 /;0;0;0;
5259;Kolekcja Silver - Pies 25cm  / 045393 / ;0;0;0;
5260;Kolekcja Silver - Pies 35cm;0;0;0;
5261;Miś Zbyś 2 kolory z kokardką 23 cm  /046345 / ;0;0;0;
5262;Pies Colin Leżący 2 kolory 50cm  /046000 / ;1;0;1;
5263;Pies Dżeki   23 cm  /046376 / ;0;0;0;
5264;Lalka Maja 20cm  /045836 / ;0;1;1;
5265;Lalka Tosia 35 cm;0;1;1;
5266;Miś i Piesek Bebik 23 cm;0;0;0;
5267;Baby Krówka Siedząca z Grzechotką 16 cm;0;0;0;
5268;Bajkowe Słoneczko 35 cm;0;2;2;
5269;Bajkowy Księżyc z Misiem 33cm;0;0;0;
5271;Kolekcja Kakao - Miś 30cm;0;0;0;
5272;Tor dla autek  /963332 / ;6;6;12;
5273;Zestaw Kuchenny  /973171/;3;4;7;
5274;Ubranko dla lalek  /126873/;-2;24;22;
5275;Akcesoria dla lalek  /126866/;5;10;15;
5276;Stemple/127634/;2;8;10;
5277;Dwa pingwiny/126262/;3;0;3;
5278;Wiatraczek /12 szt displ/125043;39;99;138;
5279;Auto/124657/;0;5;5;
5280;Piłka/126521/;4;5;9;
5281;Lizak policyjny/125449/;21;1;22;
5282;Szczęka nakręcana /127603/;31;0;31;
5283;Auto /124794/;0;0;0;
5284;Stemple  /127627/;2;0;2;
5285;Żyrafa na baterie /127009/;1;0;1;
5286;Słonik na baterie  /126996/;3;0;3;
5287;Samolot na baterie  /125944/;11;17;28;
5288;Sorter dla malucha123872, 127283;2;15;17;
5289;Konik świecący  /119899/;1;0;1;
5290;Auto  /123889/;2;19;21;
5291;Gitara  /118823/;6;0;6;
5292;Zestaw lekarski   /107568/;2;0;2;
5293;Stół + krzesła /075874/;3;0;3;
5294;Płyn do baniek mydlanych 0.5L   /125494/;4;0;4;
5295;Helikopter, światło, dzwięk /842716/;0;7;7;
5296;Zestaw kuchenny /458325/;9;15;24;
5298;Zestaw Żołnierzy /duży /360572/;0;6;6;
5299;Motocykl, światło,dzwięk /162787/;1;20;21;
5300;Pistolet na kulki wodne /TG379423/;12;6;18;
5301;Traktor z maszyną rolniczą /G030170/ 900382/;1;12;13;
5302;Traktor z przyczepą /G030391/9001006/;14;0;14;
5303;Traktor z maszyną rolniczą /G045128/944928/012398;13;0;13;
5304;Traktor z maszyną rolniczą /G084556/977247/;4;10;14;
5305;Dinozaur na baterie /515294/;7;0;7;
5306;Zestaw Policja 0165320;10;36;46;
5307;Traktor  /114422/;9;0;9;
5309;Malowidła dla lalek /TG220150/ 875123/;2;22;24;
5310;Kolejka -ruchome zwierzątka ludzik, 3 wagony /TADY231/393944/;0;0;0;
5311;Młotek edukacyjny, św.,dźw./TA384/392282/;0;0;0;
5312;Pianinko pojazdym 5 wzorów /TA5032/393920/;3;4;7;
5313;Gra rodzinna leśne przygody /TAN3015/393982/;0;0;0;
5314;Helikopter, św., dźw. /394316/;0;3;3;
5315;Autka z ludzikiem, friction /004735/;0;0;0;
5316;Samochodzik w displayu, św.,dźw/390721/;4;10;14;
5317;Lokomotywki nakręcane /392596/;24;0;24;
5318;Zestaw księżnczki, korona, diadem i akc. /004292/;0;15;15;
5319;Leżaczek z wibracjami /95009/;0;0;0;
5320;Leżaczek  z wibracjami i dźw. do 18 kg. /395061/;0;0;0;
5321;Leżaczek dla dziecka do 18 kg. wibracje, dźwięk /94583/;0;0;0;
5322;Leżaczek dla dziecka do 18 kg. wibracje, dźwięk /394576/;0;0;0;
5323;Leżaczek dla dziecka do 18 kg. wibracje, dźwięk /394590/;0;0;0;
5324;Mini cymbergaj na baterie /G030814/ 920557/;1;1;2;
5325;Zestaw rycerski /G044154/ 941224/;4;13;17;
5326;Lalka z dźwiękiem /G090049/985761/;0;0;0;
5327;Auto straż z napędem 33 cm / 874645/;14;0;14;
5328;Robot na blistrze 802993;16;36;52;
5329;Robot na blistrze /803044/;3;2;5;
5330;Lalka z akcesoriami /879114/;3;15;18;
5331;Koniki na blistrze /805918/;10;0;10;
5332;Lalka z akcesoriami /941101/;2;13;15;
5333;Malowidła dla lalek  /986485/;18;0;18;
5334;Lalka z akcesoriami /952480/;0;0;0;
5335;Malowidła dla lalek  /956839/;2;0;2;
5336;Auto policja z napędem  /979012/;26;0;26;
5337;Zestaw samochodów z matą /MPH16568X/816568/;-1;1;0;
5338;Pistolet na baterie w zestawie /MPI9822X/098228/;3;29;32;
5339;Lalka /zielona/  bobas j.polski /TG00014/877257/;-3;3;0;
5340;Lalka szmacianka j.polski /TG400738/810684/;-14;17;3;
5342;Gra skaczące żabki j.polski /TG379450/810356/;1;4;5;
5343;Lalka długie włosu j.polski 55 cm /TG000022/804898/;0;3;3;
5344;Gra chwiejna wieża j.polski /810370/TG220193/;0;17;17;
5345;POCIĄG+WAGON ŚW/MUZYKA 40CM. /G044736/          941668;16;6;22;
5346;KARETA Z LALKĄ  /G075188,92/ 970743,996;0;0;0;
5347;Klocki-Sluban Farma (103 el.)   /965701/;2;11;13;
5348;Klocki-Sluban Miasto (167 el.)  /969938/;3;1;4;
5349;Auto Śmieciarka (Światło, dźwięk)  /976202/;5;8;13;
5350;Auto przewrotka na baterie /982319/;22;51;73;
5351;Klocki-Sluban Straż (74el. )  /955160/;0;17;17;
5352;Klocki-Sluban Miasto (85 el.)  /955177/;4;0;4;
5353;LALKA+MAŁA Z WÓZKIEM NA KARCIE /MPA20197/       201970;22;0;22;
5354;Kuchnia /103410/;0;0;0;
5355;Auto  /391090/;-14;15;1;
5356;Auto  /262715/;-6;7;1;
5357;Para z dzieckiem + akc.  948328;14;10;24;
5358;Auto laweta policja + helikopter + 2 figurki  /313233/;-6;9;3;
5359;Auto na baterie 4 wz /412158/;1;4;5;
5361;Układanka - co lubią zwierzęta /803122/;0;3;3;
5362;Układanka - kim zostanę /803146/;0;3;3;
5363;Układanka - pierwsze cyferki /803115/;1;0;1;
5364;EDU 2+2  /804013/;1;0;1;
5365;Zestaw lekarski /MPH59766x/597660;0;8;8;
5366;Zestaw lalek 11' /MPI10702x/107029/;35;0;35;
5367;Samochód na baterie /810790/ MPE81079X;0;15;15;
5368;Mikrofon na baterie /717877/ MPE71787;1;7;8;
5369;Klocki 54 el.  /544473/ MPD54447X;1;7;8;
5370;Traktor 109912;20;0;20;
5371;Aparat na baterie /F3055/81776/;0;7;7;
5372;Lalka sikająca/B764/133154/;18;9;27;
5373;Kareta /B753/133178/;1;10;11;
5374;Auto TIR 3 poziomy /994155/;10;0;10;
5375;Traktor z narzędziem  /992984/ ;4;14;18;
5376;Auto /993974/;5;17;22;
5377;Auto TIR /994131/;33;2;35;
5378;Lalka przytulanka z dźwiękiem /G076180/971504/;24;0;24;
5379;Samochodziki w worku, frict. 3wz 396358;3;0;3;
5380;JEEP WOJSKOWY Z PRZYCZEPĄ ORAZ ARMATĄ 46 CM /994018/;9;6;15;
5381;Karabin na wodę /134078/;11;0;11;
5382;Karabin na wodę /133970/;13;0;13;
5383;Karabin na wodę /134281/;18;0;18;
5384;Karabin na wodę /133864/;1;0;1;
5385;Karabin na wodę /133826/;14;0;14;
5386;Karabin na wodę /122318/;9;0;9;
5387;Pistolet na wodę + zbiornik /134298/;4;0;4;
5388;Pistolet na wodę133949;3;0;3;
5389;Pistolet na wodę /133932/;17;0;17;
5391;Lalka147351;30;0;30;
5393;Lalka689978;21;0;21;
5394;Zestaw domek168216;0;27;27;
5395;Zestaw kuchenny361391;8;0;8;
5396;Pistolet na wodę133925;24;35;59;
5398;Lornetka 6szt/Display  179606;8;6;14;
5399;Piłka Magiczna  791211;63;0;63;
5400;Doktor z akcesoriami, efekty świetlne 390653;4;27;31;
5401;Klocki-przyssawki, duże elementy 395993;0;0;0;
5402;Zestaw fryzjerka 056090;6;4;10;
5404;Buda 210673;-12;22;10;
5413;Pompon 400039;-23;26;3;
5418;Torebka Cekin Średnia;43;2;45;
5419;Torebka Cekin Mała /12 opakowanie/;-41;43;2;
5450;Zabawka na bat Żaba YJ-3008 0048817;30;11;41;
5452;Zestaw wędka z rybkami 814958;16;49;65;
5453;Auto policja terenowa 811384;11;104;115;
5454;Traktor budowlany 800852;1;45;46;
5455;Pistolet na bańki 798838;12;93;105;
5456;Zestaw rakietek 984590;0;46;46;
5457;Zestaw kuchenny 069693;0;24;24;
10467;"Wózek ""Zuzia""";2;1;3;
11146;"Wózek ""Daria Lux""";0;3;3;
11602;Wózek Alicja;0;1;1;
11795;Wózek Kaja lux;0;1;1;
11811;W-60 HULAJNOGA;1;0;1;
11848;Wózek Iga lux;0;0;0;
1264;ZESTAW RYCERSKI Z HEŁMEM /62339/  BC            962339;1;7;8;
12812;Kosiarka 2;10;5;15;
13044;Wózek marketowy ;11;0;11;
13279;"Wózek ""Madzia""";0;2;2;
13888;"Wózek ""Daria""";0;3;3;
14218;AUTKO PRZEWROTKA   /1525/;0;0;0;
14220;BAńKA PAłKA;0;0;0;
14222;PODKOSZARKA;0;0;0;
14223;BUDA DUżA + DOKTOR 128;0;0;0;
14291;PCHANKA KOGUT;-6;6;0;
14351;Wózek Ania;2;3;5;
14454;BAńKI STRAż + POLICJA;-21;21;0;
14458;HELIKOPTER NA BATERIE;0;0;0;
14459;KULA ROZKłADANA DUżA;0;0;0;
14460;KULKI 6 MM 1000 SZT;-3;3;0;
14462;LALKA;0;0;0;
14463;LALKA śWIECąCA;0;0;0;
14464;MYSZKI W PUDEłKU;0;0;0;
14465;NARZęDZIA WIERTARKA;0;0;0;
14470;PISTOLET SPRężYNOWY 200102;-139;161;22;
14471;PISTOLET SPRężYNOWY 200195;12;0;12;
14474;PISTOLET SPRężYNOWY;17;0;17;
14475;PISTOLET SPRężYNOWY;24;0;24;
14478;PTAK PODWÓJNY;0;0;0;
14479;PTAK PAPUGA POWTARZAJąCY;0;0;0;
14480;PISTOLET SYGNAłOWY;0;0;0;
14482;TOREBKA MAŁA KOTEK;0;0;0;
14485;TELEFON BLISTER Z LALKą;0;0;0;
1480;GITARA ELEKTR.50CM. W KARTONIE                  206038;0;0;0;
15034;Żabka skacząca /10szt w op/ ;24;110;134;
15036;Skaczący pająk czarny /10szt w op/;279;243;522;
15084;Kaczor kłapiący MAX;-8;8;0;
15086;Zając z dzwonkiem;0;0;0;
15089;W-14 Piramidka;-54;54;0;
15094;W-22 Super gra;-9;15;6;
15176;Bańki x24;35.4167;0;35.4167;
15221;Winchester;-57;111;54;
15297;Gra piłkarze;2;8;10;
1749;MALOWIDŁA DLA LALKI-DELFINEK  /TG206956/  70838,069565;0;0;0;
20020;Piesek ;56;1;57;
211496;ZESTAW MUZYCZNY;0;0;0;
2241;SZACHY 3 W 1  NO.3038A /GO44597/                939504;0;0;0;
2537;GRA FOOTBALL/PIŁKARZE/D/                        000035;0;0;0;
262;JEEP 29CM.  /MPC45087/   KLOSZ                  450873;0;0;0;
2849;TRAKTOR WESOŁY Z WALCEM B/O.  /G042389/         941910;0;0;0;
2862;PARKING + 5 POJAZDÓW /MPH58598/                 585988;0;0;0;
2942;KAJDANKI METAL Z FUTERKIEM  /Z2584/             962069;0;0;0;
30319;UBRANKO DLA LALEK /KAR/                         150016;13;9;22;
310;GRA-MAŁA SYRENKA /KRUK/                         051467;0;0;0;
32732;Kręgle Maxi 6+1 /050483/;6;0;6;
32735;"Motorek ""Mati"" /050360/";1;0;1;
32736;"Motorek ""Sport New"" /050179/";1;0;1;
33243;Tablica do pisania-Ekologic;1;2;3;
34213;Straż pożarna 300064;-6;12;6;
34217;KLOCKI ZESTAW śREDNI                            300255;1;0;1;
34228;KASA FISKALNA;0;0;0;
34229;KASA NA BATERIE;6;0;6;
4388;MIECZ Z BAńKAMI                               62872;0;0;0;
556877;AUTO;0;0;0;
70160;Komplet karbowany 163001;-11;23;12;
70161;Komplet karbowany z konewką 163018;-19;25;6;
70164;Komplet zamek z konewką 163063;3;51;54;
70165;Komplet zamek 163056;3;36;39;
70166;Łopatka duża 163025;5;31;36;
70216;Trąbka duża /10szt paczka/;-16;157;141;
70231;Konewka duża 050469;10;30;40;
70403;W-50 WÓZEK Z RĄCZKĄ ;0;0;0;
70460;Renifer;1;0;1;
70754;ŁOPATA VIKING /PLAST/ 163142;11;35;46;
70817;KOMBAJN DO ZBOŻA 34CM 754579, 395672;0;0;0;
72288;Auto na baterie FW-2033A Transf 0207935;57;52;109;
72301;Straż na baterie B938A 747569;0;47;47;
72330;Traktor z przyczepą /872245/;2;5;7;
72540;Sygnałowy pistolet 20103-1;19;12;31;
72541;Sygnałowy pistolet LX3688;-11;43;32;
72542;Sygnałowy pistolet 140-1;84;15;99;
72543;Sygnałowy pistolet LX6511;30;16;46;
72544;Sygnałowy pistolet świecący rf223-1;54;82;136;
72580;Hula Hop 60 050032;-10;20;10;
72581;Hula Hop 80 050230;-20;20;0;
72582;Hula Hop 90 050278;0;20;20;
72731;Hula Hop 70 050049;-2;20;18;
72733;"Motorek ""Cross"" 050186";2;1;3;
72734;"Motorek ""Cross 2"" 050261";2;0;2;
72778;Pies powtarzający 3113;47;35;82;
72806;Piesek chodzący 17-1 Puchate;-63;123;60;
72902;Lornetka Plastik 6x30 0070716;48;31;79;
73120;Traktor wielki 150712;12;2;14;
73121;Traktor wielki /060773/;3;0;3;
73122;Traktor wielki /922914/;7;6;13;
73172;Pistolet na kulki NR-M37-1 201178;35;27;62;
73330;Pistolet na kulki NR-338-1 200836;15;24;39;
73331;Pistolet na kulki NR-1538D 200690;13;31;44;
73332;Pistolet na kulki NR-M41 776873;7;29;36;
73560;Magiczne Koła 1348-2;30;0;30;
73566;Lalka 558-C 417317;7;14;21;
73567;Lalka 5682A-2 422823;12;25;37;
73731;Pies chodzący na bat york 3111 100654;-13;49;36;
73959;Glut Owoc;192;0;192;
74178;Kolejka na baterie YJ88-25 110799;11;32;43;
74219;Auto przewrotka stunt 999G-19A;48;30;78;
74221;buda doktor kot 147801;26;0;26;
74225;buda duza + pies 121;27;19;46;
74226;HELIKOPTER NA BATERIE;25;35;60;
74245;Żelowy Pistolet M02 Blister;-7;52;45;
74246;Żelowy Pistolet M03+ Blister;15;36;51;
74418;Wiertarka na baterie /571818/;41;29;70;
74448;Bańki MY193Y-2 Koń Mały;-26;59;33;
74453;Bańki MY10080-2 Rozkładane;-32;54;22;
74455;BUDA DUżA DOKTOR 183 561974;42;17;59;
74457;DINOZAUR Z ROGAMI;12;18;30;
74461;KULKI 800 SZT GRANAT 707167;331;230;561;
74466;PISTOLET SPRężYNOWY 200706;-28;28;0;
74467;PISTOLET SPRężYNOWY 200942;-38;80;42;
74468;Pistolet na kulki 508-1 201024;-29;29;0;
74469;Pistolet na kulki  MP40;55;0;55;
74472;PISTOLET SPRężYNOWY;74;0;74;
74473;PISTOLET SPRężYNOWY;104;0;104;
74476;PTAK NA BATERIE 712887;-51;51;0;
74477;Ptak na baterie HL517EFGH 028031;67;72;139;
74481;Tablet edukacyjny QC1059PL 423226;5;66;71;
74483;Bańki MY10086Y-2 Muzyka;-36;60;24;
74523;Kulki 6mm 719565;69;97;166;
74538;Pistolet na kulki NR-M306B 777863 777863;10;14;24;
74544;gniotek siatka szt. /12 paczka/;-12;17;5;
74545;Kombajn duży zboże 8089,960304, 005070;17;3;20;
74546;KOMBAJN DUZY do kukurydzy 971183, 005087;11;6;17;
74551;Broń karabin /60069/;28;0;28;
74552;Pistolet na kulki NR-4 Snajp 014333;45;38;83;
74553;Żelowy pistolet plansza AK47-2;9;3;12;
75082;Wiewiórka z karuzelką ;25;0;25;
75092;W-51 Taczka stokrotka z łopatką i grabkami;4;3;7;
75228;Koparka duża na napęd /0045569/;5;15;20;
75229;Spychach 0045568;4;17;21;
75232;Traktor z pługiem /MA9044B/;0;0;0;
75390;Traktor Wielki 922822;5;3;8;
75392;Traktor Wielki792808;5;13;18;
75403;Traktor wielki z belownicą922730;6;11;17;
75405;Buda doktor pies 147795;4;0;4;
75406;Pistolet na kulki 507-1 200973;-73;84;11;
75407;Pistolet na kulki 9621 201307;12;30;42;
75408;Pistolet na kulki żelowie, plastikowe H12-2 372899;-96;186;90;
75409;Pistolet na kulki M039-3 201260;78;0;78;
75410;Pistolet na kulki 999-1 201079;-22;45;23;
75411;Plusz Kot Polska Muzyka 112030;7;2;9;
75412;Plusz Pies Polska Muzyka 112061;6;0;6;
75415;Ptak na baterie HL513AB 206621;-4;4;0;
75416;Ptak na baterie HL513EFGH  712887;11;38;49;
75417;Ptak na baterie HL519B 712924;12;0;12;
75420;Torebka z pieskiem /12 szt pakowane/;241;357;598;
75421;PTAK NA BATERIE HL510B 917856;54;45;99;
75422;Pistolet Gonher 124/0;0;5;5;
75423;Pistolet Gonher 124/6;0;5;5;
75424;Pistolet Gonher 125/0;0;5;5;
75425;Pistolet Gonher 125/6;2;3;5;
75426;Pistolet Gonher 73/0;0;0;0;
75427;Pistolet Gonher 73/6;2;1;3;
75428;Pistolet Gonher 80/0;1;4;5;
75429;Pistolet Gonher 80/6;0;5;5;
75430;Pistolet Gonher 88/0;1;4;5;
75431;Pistolet Gonher 88/6;0;5;5;
75432;Karabin Gonher 118/6;0;2;2;
75433;Pistolet Gonher 125/1;0;3;3;
75434;Karabin Gonher 137/6;0;2;2;
75435;Pistolet Gonher 33/0;1;2;3;
75436;Pistolet Gonher 39/0;0;3;3;
75437;Pistolet Gonher 39/6;1;2;3;
75438;Pistolet Gonher 45/0;0;3;3;
75439;Pistolet Gonher 45/1;0;3;3;
75440;Pistolet Gonher 46/0;0;3;3;
75441;Pistolet Gonher 46/6;0;3;3;
75442;Pistolet Gonher 95/0;0;2;2;
75443;Pistolet Gonher 98/0;0;2;2;
75444;Pistolet Gonher 98/6;0;2;2;
75445;Pistolet Gonher 99/0;0;2;2;
75446;Pistolet Gonher 99/6;0;2;2;
75447;Pistolet Gonher 133/6;0;2;2;
75448;Karabin Gonher 1135/6;0;2;2;
75449;Pistolet Gonher 136/6;0;2;2;
75451;Buda duża pies + dr 122;15;23;38;
75458;Żelowy Pistolet M16-2;16;0;16;
75459;Żelowy Pistolet XH085;-15;68;53;
75460;Żelowo Uzupełnienie Butelka M1 ;-39;456;417;
75461;Żelowe Uzupełnienie YT-001 /24szt displ/;62;82;144;
CS12850;Diabełki 6/50;1;5;6;
JC07;fajerwerki 6/1;0;6;6;
P0002;Fajerwerki;3;3;6;
PXG105;Diabełki 6/50;1;3;4;
YT1301;Diabełki 6/50;5;1;6;
YT1303;Diabły 6/50;2;0;2;
